Tick,NewlyInfected,NewlyRecovered,TotalSusceptible,TotalInfected,TotalRecovered,StepTimeNanos
0,2,0,562494,6,0,1150100
1,3,0,562490,10,0,410600
2,3,0,562487,13,0,349000
3,4,1,562485,14,1,337700
4,6,1,562478,20,2,261300
5,4,0,562473,25,2,237000
6,2,2,562471,25,4,233500
7,15,2,562457,37,6,220900
8,9,2,562447,45,8,188600
9,10,0,562437,55,8,241000
10,8,2,562429,61,10,219100
11,9,4,562422,64,14,194400
12,5,2,562418,66,16,218200
13,17,6,562398,80,22,233900
14,16,2,562386,90,24,201400
15,15,8,562369,99,32,235500
16,21,8,562347,113,40,217300
17,18,6,562329,125,46,250600
18,14,4,562317,133,50,248600
19,18,1,562299,150,51,236600
20,9,12,562290,147,63,220300
21,20,7,562270,160,70,232800
22,20,9,562249,172,79,252500
23,14,15,562234,172,94,241900
24,12,12,562224,170,106,243200
25,14,10,562208,176,116,231000
26,25,12,562183,189,128,225200
27,19,12,562165,195,140,248000
28,27,8,562141,211,148,292500
29,22,10,562115,227,158,239900
30,22,13,562097,232,171,232900
31,27,13,562071,245,184,255400
32,22,19,562048,249,203,295700
33,34,12,562012,273,215,275200
34,29,15,561986,284,230,340400
35,39,14,561948,308,244,264800
36,30,13,561915,328,257,308400
37,25,9,561889,345,266,241100
38,36,20,561857,357,286,241900
39,28,22,561825,367,308,246600
40,32,21,561798,373,329,253900
41,32,27,561764,380,356,264600
42,34,17,561730,397,373,263600
43,32,18,561699,410,391,273200
44,25,29,561673,407,420,235100
45,39,20,561634,426,440,251000
46,42,25,561597,438,465,235000
47,36,26,561553,456,491,211700
48,43,20,561518,471,511,350900
49,52,31,561465,493,542,320600
50,44,27,561419,512,569,292300
51,48,28,561368,535,597,275300
52,36,33,561330,540,630,253500
53,46,26,561285,559,656,219200
54,63,28,561234,582,684,242700
55,46,29,561180,607,713,259600
56,47,34,561129,624,747,230100
57,43,43,561089,621,790,239900
58,36,43,561057,610,833,256200
59,56,28,560998,641,861,371100
60,61,30,560932,677,891,253900
61,69,36,560872,701,927,236700
62,46,33,560823,717,960,214200
63,59,42,560767,731,1002,214000
64,68,38,560698,762,1040,247800
65,55,37,560642,781,1077,249000
66,51,55,560585,783,1132,249300
67,73,44,560520,804,1176,258600
68,68,47,560453,824,1223,299300
69,61,44,560387,846,1267,217900
70,64,47,560329,857,1314,260800
71,66,44,560262,880,1358,248200
72,65,45,560194,903,1403,238700
73,69,37,560128,932,1440,217200
74,88,49,560045,966,1489,256100
75,85,55,559951,1005,1544,226700
76,74,61,559883,1012,1605,213000
77,82,67,559799,1029,1672,236600
78,71,57,559724,1047,1729,246600
79,95,50,559638,1083,1779,239900
80,74,49,559560,1112,1828,269600
81,81,57,559486,1129,1885,258700
82,74,55,559403,1157,1940,235500
83,93,48,559315,1197,1988,229800
84,85,63,559227,1222,2051,332300
85,74,57,559153,1239,2108,255300
86,79,60,559075,1257,2168,252500
87,94,72,558977,1283,2240,268300
88,81,62,558901,1297,2302,271500
89,76,56,558819,1323,2358,227300
90,85,66,558743,1333,2424,276600
91,75,64,558654,1358,2488,257600
92,93,74,558566,1372,2562,249900
93,92,73,558481,1384,2635,223400
94,94,82,558397,1386,2717,254300
95,84,78,558300,1405,2795,251900
96,109,69,558191,1445,2864,266100
97,78,84,558112,1440,2948,290900
98,98,70,558017,1465,3018,262300
99,101,75,557918,1489,3093,244500
100,90,63,557828,1516,3156,286800
101,106,70,557721,1553,3226,224100
102,123,87,557607,1580,3313,316800
103,127,95,557477,1615,3408,246600
104,85,91,557381,1620,3499,260900
105,111,73,557276,1652,3572,224300
106,101,80,557170,1678,3652,268000
107,107,81,557072,1695,3733,288700
108,109,86,556958,1723,3819,635100
109,130,92,556838,1751,3911,811300
110,111,91,556725,1773,4002,832800
111,92,103,556629,1766,4105,1643300
112,117,90,556522,1783,4195,1099000
113,112,88,556397,1820,4283,578800
114,115,105,556284,1828,4388,665700
115,114,95,556171,1846,4483,244100
116,111,85,556061,1871,4568,255100
117,128,89,555933,1910,4657,244600
118,113,99,555822,1922,4756,209100
119,110,107,555712,1925,4863,197800
120,118,106,555598,1933,4969,232700
121,126,108,555472,1951,5077,223600
122,126,118,555337,1968,5195,193800
123,116,117,555218,1970,5312,239300
124,107,96,555116,1976,5408,208400
125,129,98,554987,2007,5506,207000
126,101,111,554883,2000,5617,227600
127,111,130,554776,1977,5747,225500
128,116,103,554657,1993,5850,232200
129,136,83,554523,2044,5933,215700
130,134,103,554389,2075,6036,189200
131,141,118,554246,2100,6154,196500
132,123,97,554124,2125,6251,191100
133,138,129,553994,2126,6380,214200
134,125,98,553863,2159,6478,201400
135,126,127,553741,2154,6605,196000
136,140,100,553606,2189,6705,233700
137,150,114,553444,2237,6819,229300
138,148,125,553314,2242,6944,198100
139,141,131,553166,2259,7075,218300
140,143,117,553020,2288,7192,235500
141,154,104,552858,2346,7296,202000
142,153,120,552715,2369,7416,225000
143,157,122,552560,2402,7538,218500
144,151,125,552405,2432,7663,255200
145,157,128,552243,2466,7791,223600
146,160,128,552081,2500,7919,228900
147,166,135,551931,2515,8054,246500
148,158,142,551761,2543,8196,211000
149,183,130,551591,2583,8326,216400
150,174,148,551404,2622,8474,223900
151,163,164,551254,2608,8638,222400
152,159,129,551083,2650,8767,195600
153,167,138,550915,2680,8905,217200
154,156,124,550768,2703,9029,235100
155,164,150,550602,2719,9179,212800
156,206,131,550391,2799,9310,184100
157,193,156,550199,2835,9466,244000
158,188,137,550020,2877,9603,213700
159,163,141,549846,2910,9744,217500
160,186,153,549669,2934,9897,209400
161,187,140,549474,2989,10037,198400
162,196,152,549290,3021,10189,256200
163,194,174,549095,3042,10363,210600
164,195,167,548891,3079,10530,200600
165,187,184,548703,3083,10714,232200
166,192,154,548504,3128,10868,202000
167,205,171,548312,3149,11039,201000
168,201,165,548102,3194,11204,237000
169,196,198,547914,3184,11402,225000
170,180,182,547728,3188,11584,213900
171,170,167,547568,3181,11751,196700
172,193,137,547370,3242,11888,186700
173,171,165,547199,3248,12053,212100
174,186,148,547010,3289,12201,225000
175,204,190,546817,3292,12391,226000
176,210,164,546604,3341,12555,214600
177,200,178,546408,3359,12733,191300
178,225,147,546186,3434,12880,207300
179,218,175,545957,3488,13055,223800
180,207,178,545746,3521,13233,202300
181,203,161,545552,3554,13394,202900
182,178,199,545360,3547,13593,222400
183,214,187,545162,3558,13780,219500
184,194,189,544965,3566,13969,195400
185,214,171,544742,3618,14140,218500
186,202,171,544548,3641,14311,246500
187,204,219,544347,3623,14530,254000
188,213,196,544128,3646,14726,206900
189,223,190,543912,3672,14916,207500
190,217,187,543692,3705,15103,224700
191,210,185,543487,3725,15288,219700
192,211,196,543268,3748,15484,241400
193,230,194,543050,3772,15678,250000
194,225,206,542805,3811,15884,250100
195,199,196,542618,3802,16080,188900
196,230,192,542388,3840,16272,220400
197,246,198,542145,3885,16470,233900
198,221,184,541920,3926,16654,219600
199,244,188,541672,3986,16842,215000
200,215,183,541463,4012,17025,208200
201,274,178,541195,4102,17203,236700
202,242,198,540953,4146,17401,227700
203,222,210,540718,4171,17611,193100
204,230,203,540495,4191,17814,208800
205,264,207,540235,4244,18021,226700
206,243,208,540002,4269,18229,219300
207,258,227,539731,4313,18456,265000
208,213,224,539504,4316,18680,232600
209,242,210,539270,4340,18890,276500
210,269,225,539006,4379,19115,216000
211,246,237,538768,4380,19352,196400
212,241,219,538514,4415,19571,224900
213,242,203,538271,4455,19774,235900
214,264,239,538023,4464,20013,218300
215,206,242,537812,4433,20255,219200
216,232,246,537580,4419,20501,244100
217,231,260,537355,4384,20761,203700
218,236,212,537102,4425,20973,204000
219,271,229,536849,4449,21202,206300
220,249,224,536588,4486,21426,211000
221,272,226,536325,4523,21652,236400
222,272,214,536049,4585,21866,211800
223,260,227,535801,4606,22093,215100
224,297,243,535488,4676,22336,233600
225,269,225,535221,4718,22561,200400
226,267,223,534952,4764,22784,204200
227,272,245,534676,4795,23029,226900
228,240,254,534445,4772,23283,206500
229,260,246,534179,4792,23529,303500
230,266,258,533911,4802,23787,223800
231,312,265,533612,4836,24052,225500
232,299,242,533312,4894,24294,246400
233,280,255,533036,4915,24549,208800
234,311,240,532727,4984,24789,219500
235,260,259,532463,4989,25048,207900
236,280,289,532179,4984,25337,234000
237,296,259,531880,5024,25596,229100
238,287,262,531595,5047,25858,263100
239,272,265,531328,5049,26123,291900
240,303,246,531013,5118,26369,225400
241,325,254,530704,5173,26623,200000
242,263,286,530447,5144,26909,251800
243,312,273,530131,5187,27182,244700
244,314,294,529816,5208,27476,197600
245,310,252,529494,5278,27728,202400
246,303,241,529192,5339,27969,214600
247,255,283,528934,5314,28252,205200
248,291,275,528649,5324,28527,208200
249,285,280,528356,5337,28807,225600
250,321,248,528046,5399,29055,305900
251,326,258,527720,5467,29313,256500
252,292,275,527419,5493,29588,226900
253,282,322,527144,5446,29910,226600
254,319,285,526836,5469,30195,207200
255,285,303,526537,5465,30498,216700
256,300,250,526229,5523,30748,224200
257,316,271,525918,5563,31019,213000
258,315,310,525620,5551,31329,233200
259,331,304,525281,5586,31633,217700
260,315,289,524970,5608,31922,221700
261,277,291,524678,5609,32213,220300
262,269,281,524409,5597,32494,193300
263,281,299,524131,5576,32793,212800
264,295,304,523836,5567,33097,209200
265,325,310,523508,5585,33407,317500
266,293,292,523221,5580,33699,247100
267,272,288,522946,5567,33987,216300
268,309,293,522643,5577,34280,206400
269,356,308,522301,5611,34588,232500
270,343,280,521941,5691,34868,192200
271,311,303,521643,5686,35171,232700
272,327,293,521310,5726,35464,216500
273,333,295,520989,5752,35759,206200
274,346,295,520635,5811,36054,206500
275,338,308,520300,5838,36362,199500
276,294,282,520007,5849,36644,215400
277,358,299,519644,5913,36943,198300
278,305,303,519348,5906,37246,210200
279,333,331,519000,5923,37577,193800
280,314,297,518687,5939,37874,219900
281,367,299,518332,5995,38173,206500
282,328,352,517999,5976,38525,213300
283,298,349,517695,5931,38874,204400
284,310,293,517388,5945,39167,190100
285,297,325,517084,5924,39492,219700
286,335,312,516775,5921,39804,248500
287,332,335,516437,5924,40139,230800
288,324,294,516104,5963,40433,262800
289,346,321,515760,5986,40754,242900
290,348,336,515414,5996,41090,247000
291,341,296,515070,6044,41386,217600
292,325,312,514747,6055,41698,231500
293,343,337,514394,6071,42035,231600
294,354,317,514037,6111,42352,231700
295,339,327,513691,6130,42679,238600
296,352,299,513358,6164,42978,238100
297,356,332,513000,6190,43310,216900
298,337,324,512653,6213,43634,220500
299,365,351,512299,6216,43985,194400
300,314,292,511978,6245,44277,216100
301,369,291,511616,6316,44568,217500
302,348,347,511273,6312,44915,212400
303,345,326,510917,6342,45241,222400
304,330,327,510585,6347,45568,230100
305,366,350,510232,6350,45918,211900
306,356,329,509876,6377,46247,217000
307,373,339,509507,6407,46586,228500
308,382,314,509130,6470,46900,221700
309,378,340,508736,6524,47240,220900
310,387,324,508361,6575,47564,249900
311,357,335,507991,6610,47899,205600
312,376,327,507619,6655,48226,215400
313,352,362,507256,6656,48588,221600
314,377,342,506907,6663,48930,234200
315,378,359,506519,6692,49289,296100
316,404,343,506121,6747,49632,243200
317,373,355,505737,6776,49987,243500
318,393,342,505342,6829,50329,221000
319,452,363,504895,6913,50692,256300
320,421,330,504479,6999,51022,221700
321,420,380,504059,7039,51402,296600
322,426,373,503642,7083,51775,252700
323,393,364,503232,7129,52139,238600
324,421,372,502808,7181,52511,252600
325,415,372,502392,7225,52883,245600
326,397,410,502004,7203,53293,245900
327,453,385,501563,7259,53678,251700
328,447,384,501104,7334,54062,294300
329,402,381,500710,7347,54443,236900
330,453,355,500260,7442,54798,258000
331,407,386,499837,7479,55184,382200
332,429,408,499409,7499,55592,273300
333,440,393,498989,7526,55985,317900
334,471,382,498527,7606,56367,280600
335,422,428,498069,7636,56795,294700
336,442,418,497655,7632,57213,265100
337,419,410,497234,7643,57623,296000
338,430,421,496793,7663,58044,230800
339,424,388,496372,7696,58432,237000
340,420,379,495950,7739,58811,248500
341,444,400,495509,7780,59211,260400
342,423,377,495096,7816,59588,238200
343,456,388,494627,7897,59976,240600
344,434,392,494188,7944,60368,262200
345,455,405,493748,7979,60773,248900
346,443,426,493294,8007,61199,265400
347,462,400,492825,8076,61599,245000
348,442,415,492389,8097,62014,250800
349,473,438,491927,8121,62452,277200
350,458,432,491460,8156,62884,300600
351,474,444,490999,8173,63328,268800
352,381,404,490586,8182,63732,253900
353,442,437,490168,8163,64169,384900
354,393,402,489771,8158,64571,249400
355,430,429,489340,8160,65000,236300
356,491,456,488866,8178,65456,248300
357,419,456,488422,8166,65912,240700
358,459,432,487974,8182,66344,251500
359,440,430,487536,8190,66774,252200
360,418,453,487121,8152,67227,270400
361,437,407,486672,8194,67634,266900
362,433,453,486239,8174,68087,261000
363,458,428,485789,8196,68515,222200
364,436,431,485359,8195,68946,221200
365,477,399,484866,8289,69345,243800
366,450,418,484417,8320,69763,297000
367,437,440,483976,8321,70203,252800
368,471,442,483518,8337,70645,248100
369,480,434,483038,8383,71079,267700
370,479,439,482568,8414,71518,273900
371,483,427,482077,8478,71945,249200
372,459,458,481625,8472,72403,241700
373,460,436,481159,8502,72839,310000
374,470,440,480683,8538,73279,299200
375,459,456,480227,8538,73735,286300
376,459,429,479778,8558,74164,272300
377,502,437,479287,8612,74601,276900
378,491,457,478756,8686,75058,253500
379,436,440,478342,8660,75498,330300
380,484,445,477864,8693,75943,237200
381,440,443,477400,8714,76386,234200
382,499,461,476932,8721,76847,254600
383,475,441,476458,8754,77288,240800
384,465,462,475977,8773,77750,241600
385,491,435,475485,8830,78185,243800
386,493,444,474997,8874,78629,220000
387,499,459,474495,8917,79088,246400
388,515,440,474000,8972,79528,217800
389,470,497,473511,8964,80025,222600
390,461,458,473056,8961,80483,229800
391,433,452,472616,8949,80935,250600
392,469,480,472150,8935,81415,208400
393,539,441,471609,9035,81856,248300
394,493,484,471126,9034,82340,288700
395,508,473,470608,9079,82813,240100
396,507,460,470111,9116,83273,274900
397,473,475,469629,9123,83748,225100
398,466,491,469161,9100,84239,244000
399,520,467,468644,9150,84706,232600
400,470,485,468167,9142,85191,232200
401,489,484,467690,9135,85675,237000
402,491,446,467195,9184,86121,236300
403,505,507,466700,9172,86628,218200
404,494,472,466198,9202,87100,247000
405,494,492,465699,9209,87592,218500
406,499,481,465202,9225,88073,219800
407,503,512,464697,9218,88585,221200
408,501,480,464195,9240,89065,253000
409,485,447,463722,9266,89512,231800
410,495,472,463216,9300,89984,245500
411,503,459,462718,9339,90443,229000
412,497,480,462207,9370,90923,242200
413,513,502,461718,9357,91425,241400
414,522,444,461177,9454,91869,211600
415,468,524,460718,9389,92393,319300
416,512,529,460220,9358,92922,290400
417,492,460,459704,9414,93382,267400
418,481,495,459231,9392,93877,316100
419,475,437,458756,9430,94314,395700
420,565,483,458214,9489,94797,264200
421,583,492,457629,9582,95289,271000
422,552,473,457071,9667,95762,259000
423,504,497,456566,9675,96259,308800
424,519,490,456028,9723,96749,351400
425,499,478,455527,9746,97227,389500
426,516,508,455024,9741,97735,258000
427,538,494,454486,9785,98229,268100
428,545,490,453945,9836,98719,238000
429,508,504,453417,9860,99223,258400
430,529,525,452906,9846,99748,233000
431,494,514,452404,9834,100262,272500
432,541,519,451880,9839,100781,281400
433,520,513,451352,9854,101294,313700
434,539,541,450815,9850,101835,309400
435,514,544,450289,9832,102379,313700
436,513,508,449790,9823,102887,268300
437,546,505,449242,9866,103392,278200
438,521,531,448708,9869,103923,274000
439,503,512,448205,9860,104435,227600
440,515,560,447701,9804,104995,230300
441,508,486,447186,9833,105481,267400
442,513,550,446659,9810,106031,265200
443,490,467,446164,9838,106498,271300
444,529,529,445655,9818,107027,258800
445,542,512,445116,9845,107539,246700
446,539,497,444583,9881,108036,259500
447,566,514,444018,9932,108550,238700
448,538,505,443461,9984,109055,225600
449,533,492,442943,10010,109547,252700
450,592,506,442368,10079,110053,223300
451,508,536,441831,10080,110589,223000
452,524,535,441313,10063,111124,224000
453,563,533,440774,10069,111657,263100
454,530,496,440221,10126,112153,251800
455,561,569,439666,10112,112722,267100
456,564,510,439098,10170,113232,263100
457,565,566,438546,10156,113798,279800
458,535,521,437990,10191,114319,279300
459,546,559,437448,10174,114878,256700
460,576,527,436884,10211,115405,267700
461,557,500,436321,10274,115905,238100
462,593,525,435745,10325,116430,221200
463,523,569,435193,10308,116999,230700
464,544,577,434654,10270,117576,251300
465,513,529,434139,10256,118105,236200
466,583,529,433579,10287,118634,229500
467,540,529,433035,10302,119163,239600
468,563,551,432459,10327,119714,257000
469,570,573,431879,10334,120287,235000
470,532,564,431353,10296,120851,209100
471,557,546,430795,10308,121397,271000
472,538,534,430263,10306,121931,254700
473,536,531,429724,10314,122462,248800
474,532,556,429195,10287,123018,236700
475,523,563,428680,10239,123581,231300
476,541,510,428117,10292,124091,257000
477,534,543,427589,10277,124634,248600
478,568,558,427042,10266,125192,310000
479,542,560,426478,10270,125752,249800
480,539,558,425967,10223,126310,447400
481,551,533,425414,10243,126843,249000
482,533,550,424852,10255,127393,282600
483,568,521,424306,10280,127914,256800
484,547,540,423759,10287,128454,241800
485,539,568,423214,10264,129022,264700
486,495,554,422691,10233,129576,284600
487,482,523,422229,10172,130099,230300
488,511,491,421726,10184,130590,237900
489,559,516,421169,10225,131106,280000
490,512,510,420647,10237,131616,252700
491,519,515,420121,10248,132131,245000
492,537,520,419594,10255,132651,263900
493,520,517,419080,10252,133168,297700
494,566,549,418517,10266,133717,326300
495,552,555,417963,10265,134272,347300
496,564,499,417398,10331,134771,251200
497,559,491,416842,10396,135262,244300
498,569,518,416280,10440,135780,248700
499,519,543,415724,10453,136323,316900
500,515,508,415223,10446,136831,268000
501,560,568,414656,10445,137399,260200
502,585,510,414087,10504,137909,253500
503,614,554,413472,10565,138463,232400
504,537,464,412939,10634,138927,243100
505,545,537,412386,10650,139464,260600
506,559,499,411845,10692,139963,315500
507,578,560,411256,10721,140523,269800
508,570,540,410677,10760,141063,259000
509,531,546,410153,10738,141609,224500
510,569,505,409586,10800,142114,271200
511,499,516,409078,10792,142630,261400
512,522,553,408564,10753,143183,255100
513,550,580,407998,10739,143763,273400
514,545,563,407455,10719,144326,413200
515,541,561,406926,10687,144887,349500
516,555,537,406362,10714,145424,269000
517,546,564,405823,10689,145988,252500
518,501,527,405341,10644,146515,278200
519,553,542,404778,10665,147057,256800
520,522,557,404239,10647,147614,252800
521,500,554,403741,10591,148168,292500
522,549,562,403202,10568,148730,297600
523,516,554,402678,10538,149284,273400
524,498,524,402190,10502,149808,282700
525,498,512,401690,10490,150320,256500
526,535,542,401146,10492,150862,314200
527,535,573,400617,10448,151435,271800
528,513,522,400100,10443,151957,252000
529,542,545,399561,10437,152502,273100
530,503,537,399053,10408,153039,262000
531,503,512,398551,10398,153551,305400
532,524,532,398034,10383,154083,300100
533,533,560,397503,10354,154643,262600
534,518,533,396987,10337,155176,329400
535,521,536,396462,10326,155712,280100
536,521,519,395943,10326,156231,275000
537,546,549,395397,10323,156780,267200
538,526,516,394863,10341,157296,277400
539,556,560,394312,10332,157856,261500
540,514,502,393811,10331,158358,253200
541,544,514,393263,10365,158872,277400
542,555,518,392707,10403,159390,249100
543,540,537,392154,10419,159927,287800
544,532,517,391622,10434,160444,332100
545,525,526,391113,10417,160970,262600
546,587,565,390533,10432,161535,321300
547,515,562,390002,10401,162097,299900
548,526,562,389475,10366,162659,278400
549,526,528,388936,10377,163187,296400
550,482,515,388446,10352,163702,255500
551,515,539,387946,10313,164241,276500
552,540,561,387410,10288,164802,267300
553,536,520,386862,10316,165322,323700
554,509,542,386356,10280,165864,278500
555,531,525,385844,10267,166389,288600
556,554,528,385270,10313,166917,274400
557,539,507,384756,10320,167424,287400
558,528,515,384211,10350,167939,275600
559,520,557,383682,10322,168496,258700
560,517,561,383177,10266,169057,298700
561,474,554,382688,10201,169611,292300
562,485,516,382209,10164,170127,264700
563,471,570,381742,10061,170697,235400
564,519,538,381220,10045,171235,258300
565,518,558,380702,10005,171793,285500
566,514,541,380191,9975,172334,259900
567,492,533,379698,9935,172867,277700
568,501,471,379201,9961,173338,254900
569,500,531,378693,9938,173869,277200
570,519,537,378193,9901,174406,281600
571,487,495,377699,9900,174901,306300
572,502,491,377195,9913,175392,324400
573,480,525,376708,9875,175917,321400
574,540,525,376187,9871,176442,305400
575,477,467,375682,9909,176909,327600
576,531,543,375164,9884,177452,315600
577,498,481,374658,9909,177933,257600
578,488,516,374168,9883,178449,278400
579,517,517,373672,9862,178966,263700
580,495,551,373174,9809,179517,248000
581,510,486,372659,9838,180003,305400
582,510,528,372142,9827,180531,301000
583,491,490,371649,9830,181021,249500
584,540,540,371109,9830,181561,269500
585,498,526,370617,9796,182087,235800
586,501,508,370107,9798,182595,271900
587,514,549,369617,9739,183144,258900
588,519,489,369089,9778,183633,245800
589,525,522,368566,9779,184155,253100
590,510,563,368038,9744,184718,258800
591,520,484,367537,9761,185202,360800
592,510,536,367022,9740,185738,267300
593,535,523,366492,9747,186261,253400
594,505,517,365979,9743,186778,280900
595,559,523,365418,9781,187301,257200
596,551,503,364858,9838,187804,238600
597,529,511,364349,9836,188315,261600
598,497,548,363846,9791,188863,254800
599,546,485,363315,9837,189348,246400
600,491,503,362806,9843,189851,273000
601,509,483,362294,9872,190334,269700
602,511,475,361786,9905,190809,286900
603,510,526,361264,9901,191335,244300
604,598,498,360674,9993,191833,270000
605,512,563,360163,9941,192396,256900
606,521,496,359676,9932,192892,264900
607,507,515,359135,9958,193407,249900
608,536,518,358612,9963,193925,284000
609,546,534,358056,9985,194459,257900
610,502,512,357553,9976,194971,243800
611,569,479,357001,10049,195450,385500
612,545,541,356437,10072,195991,292600
613,545,556,355895,10058,196547,263000
614,521,554,355388,10011,197101,215300
615,575,550,354819,10030,197651,251700
616,507,531,354299,10019,198182,301900
617,534,532,353751,10035,198714,265000
618,525,476,353242,10068,199190,230900
619,559,543,352680,10087,199733,300900
620,518,514,352156,10097,200247,328900
621,520,561,351638,10054,200808,250100
622,553,496,351086,10110,201304,270900
623,536,517,350553,10126,201821,299200
624,533,550,350019,10110,202371,511500
625,518,516,349497,10116,202887,672700
626,541,528,348960,10125,203415,2367400
627,495,547,348474,10064,203962,984800
628,504,530,347971,10037,204492,875600
629,492,537,347464,10007,205029,685700
630,500,533,346969,9969,205562,322300
631,505,543,346457,9938,206105,325400
632,492,517,345968,9910,206622,286400
633,473,523,345504,9851,207145,493600
634,508,514,344995,9846,207659,353400
635,457,481,344538,9822,208140,329800
636,529,528,344000,9832,208668,395200
637,502,496,343499,9837,209164,361000
638,506,533,342994,9809,209697,310500
639,520,531,342468,9804,210228,237600
640,489,502,341981,9789,210730,298700
641,542,523,341437,9810,211253,296700
642,544,523,340902,9822,211776,263900
643,529,518,340360,9846,212294,264900
644,551,528,339825,9853,212822,247100
645,480,491,339339,9848,213313,238100
646,520,504,338834,9849,213817,244900
647,537,540,338275,9868,214357,258900
648,513,503,337771,9869,214860,432700
649,515,495,337245,9900,215355,254500
650,531,505,336730,9910,215860,244200
651,515,548,336203,9889,216408,309400
652,532,484,335678,9930,216892,312000
653,530,548,335153,9907,217440,305000
654,442,546,334703,9811,217986,307500
655,548,522,334160,9832,218508,308700
656,540,480,333625,9887,218988,322600
657,499,484,333117,9911,219472,324300
658,550,546,332561,9921,220018,250600
659,538,491,332029,9962,220509,266100
660,567,541,331461,9989,221050,239000
661,532,485,330920,10045,221535,258900
662,526,533,330414,10018,222068,287100
663,531,492,329868,10072,222560,279200
664,553,551,329327,10062,223111,259600
665,559,531,328764,10094,223642,219300
666,513,519,328243,10096,224161,242000
667,532,544,327712,10083,224705,298100
668,512,531,327200,10064,225236,273100
669,542,547,326663,10054,225783,276600
670,515,473,326149,10095,226256,304000
671,531,524,325604,10116,226780,264000
672,523,519,325102,10099,227299,264400
673,493,491,324594,10116,227790,241800
674,523,524,324065,10121,228314,280500
675,551,509,323528,10149,228823,245800
676,516,538,323010,10129,229361,272900
677,529,481,322472,10186,229842,247000
678,522,521,321971,10166,230363,233300
679,547,487,321425,10225,230850,265200
680,534,525,320890,10235,231375,224000
681,538,537,320352,10236,231912,287400
682,527,487,319825,10276,232399,304200
683,505,488,319303,10310,232887,280300
684,542,556,318757,10300,233443,376800
685,539,523,318229,10305,233966,369700
686,526,547,317699,10288,234513,256900
687,574,533,317129,10325,235046,223400
688,569,542,316564,10348,235588,279200
689,519,513,316038,10361,236101,240400
690,560,507,315482,10410,236608,254800
691,513,586,314964,10342,237194,248500
692,540,517,314432,10357,237711,257600
693,529,542,313898,10349,238253,246500
694,546,525,313362,10360,238778,310100
695,576,529,312808,10385,239307,330400
696,531,541,312239,10413,239848,327900
697,513,537,311720,10395,240385,303000
698,546,530,311180,10405,240915,287600
699,531,530,310641,10414,241445,289600
700,521,542,310133,10380,241987,269200
701,518,549,309592,10372,242536,284000
702,529,509,309074,10381,243045,248500
703,502,567,308585,10303,243612,256300
704,562,530,308027,10331,244142,277100
705,546,498,307481,10379,244640,243900
706,548,515,306941,10404,245155,246400
707,557,552,306374,10419,245707,259500
708,526,560,305851,10382,246267,266500
709,562,547,305303,10383,246814,429200
710,568,526,304725,10435,247340,321000
711,529,553,304195,10412,247893,310900
712,532,555,303657,10395,248448,362100
713,543,557,303108,10387,249005,330900
714,561,533,302569,10393,249538,295200
715,526,548,302029,10385,250086,279000
716,567,513,301457,10444,250599,290500
717,546,514,300915,10472,251113,281200
718,574,553,300352,10482,251666,264800
719,568,543,299780,10511,252209,250000
720,563,539,299210,10542,252748,255300
721,549,578,298670,10504,253326,230700
722,576,548,298100,10526,253874,227600
723,600,535,297489,10602,254409,232500
724,540,557,296952,10582,254966,326600
725,575,529,296366,10639,255495,247500
726,514,545,295863,10597,256040,269500
727,566,547,295302,10611,256587,291500
728,540,540,294757,10616,257127,306800
729,574,556,294164,10653,257683,324800
730,529,551,293650,10616,258234,238200
731,563,548,293094,10624,258782,254300
732,601,571,292493,10654,259353,256900
733,532,538,291946,10663,259891,247300
734,565,545,291370,10694,260436,250700
735,583,512,290807,10745,260948,258200
736,566,547,290241,10764,261495,281000
737,546,545,289694,10766,262040,317500
738,567,526,289125,10809,262566,251600
739,560,552,288554,10828,263118,276600
740,575,600,287986,10796,263718,237500
741,618,545,287370,10867,264263,346100
742,566,558,286816,10863,264821,254900
743,560,591,286236,10852,265412,256300
744,536,563,285691,10834,265975,280400
745,558,540,285161,10824,266515,274200
746,521,587,284635,10763,267102,281100
747,549,542,284077,10779,267644,509400
748,549,582,283521,10753,268226,299200
749,604,580,282934,10760,268806,279600
750,554,566,282385,10743,269372,310700
751,515,539,281860,10729,269911,296100
752,545,590,281317,10682,270501,329800
753,490,507,280815,10677,271008,275800
754,528,558,280291,10643,271566,231900
755,555,564,279743,10627,272130,248300
756,519,570,279217,10583,272700,263700
757,540,547,278692,10561,273247,313500
758,565,525,278104,10624,273772,257100
759,553,535,277569,10624,274307,264000
760,571,552,276999,10642,274859,243200
761,564,581,276442,10618,275440,251000
762,521,568,275905,10587,276008,229200
763,555,545,275344,10603,276553,280300
764,509,555,274852,10540,277108,274000
765,521,516,274308,10568,277624,257200
766,567,515,273769,10592,278139,308200
767,494,561,273246,10554,278700,349900
768,535,521,272732,10547,279221,302200
769,499,542,272212,10525,279763,298000
770,544,513,271687,10537,280276,309700
771,562,561,271132,10531,280837,297800
772,526,527,270585,10551,281364,247000
773,560,549,270031,10556,281913,273600
774,498,570,269521,10496,282483,279700
775,527,537,269010,10470,283020,262900
776,559,552,268460,10468,283572,273700
777,495,531,267975,10422,284103,255000
778,539,513,267401,10483,284616,271000
779,559,568,266852,10464,285184,252800
780,558,536,266333,10447,285720,260300
781,521,558,265772,10450,286278,295700
782,567,544,265219,10459,286822,274600
783,544,525,264661,10492,287347,278400
784,551,524,264126,10503,287871,269300
785,553,562,263582,10485,288433,270800
786,528,549,263040,10478,288982,279900
787,526,516,262507,10495,289498,273500
788,530,565,261981,10456,290063,253300
789,526,528,261449,10460,290591,295400
790,543,567,260926,10416,291158,294700
791,543,515,260350,10477,291673,273900
792,531,541,259854,10432,292214,279500
793,550,585,259282,10419,292799,318300
794,526,551,258773,10377,293350,318300
795,512,538,258243,10369,293888,290600
796,554,552,257703,10357,294440,277800
797,516,519,257165,10376,294959,295700
798,501,558,256667,10316,295517,285000
799,532,539,256143,10301,296056,271300
800,552,535,255608,10301,296591,264400
801,558,539,255051,10319,297130,307300
802,509,506,254525,10339,297636,300900
803,493,548,254026,10290,298184,246900
804,529,536,253504,10276,298720,288400
805,544,509,252959,10312,299229,328200
806,519,526,252435,10310,299755,319300
807,514,523,251932,10290,300278,342900
808,537,540,251382,10300,300818,310900
809,539,557,250855,10270,301375,275700
810,544,542,250320,10263,301917,299500
811,523,509,249786,10288,302426,288300
812,522,523,249247,10304,302949,236100
813,519,530,248749,10272,303479,231800
814,515,506,248222,10293,303985,285800
815,500,562,247704,10249,304547,280000
816,486,550,247238,10165,305097,223800
817,511,518,246715,10170,305615,241000
818,520,519,246201,10165,306134,265000
819,511,595,245699,10072,306729,286900
820,497,541,245200,10030,307270,276700
821,540,510,244653,10067,307780,270900
822,569,526,244101,10093,308306,282300
823,548,506,243561,10127,308812,231200
824,571,509,242993,10186,309321,327400
825,543,557,242431,10191,309878,267600
826,531,523,241901,10198,310401,263300
827,521,544,241381,10174,310945,333200
828,582,573,240820,10162,311518,322700
829,551,510,240246,10226,312028,281800
830,509,547,239732,10193,312575,252800
831,514,526,239228,10171,313101,230200
832,519,525,238708,10166,313626,261800
833,529,521,238168,10185,314147,257800
834,578,549,237598,10206,314696,243600
835,539,528,237041,10235,315224,267000
836,522,523,236545,10208,315747,302300
837,568,531,235978,10244,316278,262100
838,532,505,235442,10275,316783,272500
839,547,562,234905,10250,317345,311300
840,534,563,234374,10218,317908,307400
841,588,530,233772,10290,318438,250800
842,503,557,233259,10246,318995,264400
843,545,562,232725,10218,319557,266400
844,542,536,232186,10221,320093,330800
845,515,550,231651,10206,320643,275200
846,548,511,231123,10223,321154,308700
847,578,530,230545,10271,321684,347000
848,517,541,230020,10255,322225,297800
849,548,520,229482,10273,322745,329500
850,518,530,228946,10279,323275,423100
851,487,522,228461,10242,323797,330300
852,492,505,227974,10224,324302,344500
853,555,523,227413,10262,324825,310500
854,529,551,226890,10234,325376,441200
855,508,530,226377,10217,325906,341700
856,498,513,225877,10204,326419,331600
857,483,527,225401,10153,326946,343600
858,470,537,224928,10089,327483,337300
859,534,495,224389,10133,327978,471600
860,506,564,223893,10065,328542,342200
861,478,496,223406,10056,329038,312200
862,522,497,222891,10074,329535,375000
863,474,498,222410,10057,330033,383200
864,496,518,221909,10040,330551,291000
865,491,509,221433,10007,331060,271900
866,481,529,220956,9955,331589,344300
867,502,569,220432,9910,332158,266300
868,543,509,219899,9934,332667,401100
869,483,543,219413,9877,333210,352000
870,454,517,218959,9814,333727,384800
871,508,517,218473,9783,334244,376500
872,488,484,217952,9820,334728,445300
873,526,508,217442,9822,335236,330600
874,518,503,216925,9836,335739,358800
875,506,506,216414,9841,336245,306500
876,484,496,215925,9834,336741,422600
877,513,547,215421,9791,337288,333000
878,500,528,214919,9765,337816,323100
879,520,534,214414,9736,338350,345900
880,492,491,213906,9753,338841,314200
881,496,505,213407,9747,339346,330300
882,481,526,212931,9697,339872,305300
883,526,494,212408,9726,340366,322300
884,500,497,211898,9739,340863,299400
885,485,517,211413,9707,341380,364400
886,532,538,210900,9682,341918,368700
887,495,487,210391,9704,342405,306500
888,466,530,209912,9653,342935,300900
889,465,507,209469,9589,343442,307800
890,482,509,208998,9551,343951,271100
891,484,504,208485,9560,344455,400400
892,510,474,207986,9585,344929,366400
893,491,511,207491,9569,345440,304600
894,479,486,207028,9546,345926,441700
895,482,489,206529,9556,346415,320800
896,544,520,206008,9557,346935,344000
897,483,515,205511,9539,347450,318100
898,526,477,204982,9591,347927,275000
899,457,504,204531,9538,348431,290000
900,505,509,204006,9554,348940,320800
901,514,478,203517,9565,349418,268000
902,494,512,203000,9570,349930,283600
903,529,497,202495,9578,350427,335900
904,488,499,201989,9585,350926,275300
905,543,489,201450,9635,351415,309400
906,507,502,200956,9627,351917,362300
907,516,508,200453,9622,352425,361000
908,481,512,199935,9628,352937,342000
909,519,482,199428,9653,353419,462200
910,523,563,198912,9606,353982,448300
911,517,464,198387,9667,354446,495800
912,481,554,197912,9588,355000,356300
913,495,487,197413,9600,355487,360100
914,527,502,196895,9616,355989,402200
915,479,487,196397,9627,356476,378900
916,514,498,195907,9619,356974,529100
917,486,509,195412,9605,357483,285100
918,485,483,194929,9605,357966,338600
919,486,498,194442,9594,358464,348700
920,493,496,193941,9599,358960,328600
921,508,496,193439,9605,359456,526900
922,440,524,192986,9534,359980,404100
923,447,525,192538,9457,360505,355400
924,457,478,192095,9422,360983,324500
925,464,457,191621,9439,361440,369700
926,519,514,191113,9433,361954,360600
927,454,491,190655,9400,362445,326900
928,485,466,190163,9426,362911,287800
929,525,507,189659,9423,363418,323000
930,478,458,189159,9465,363876,333700
931,466,470,188699,9455,364346,301800
932,517,497,188169,9488,364843,338700
933,530,487,187672,9498,365330,477900
934,497,506,187148,9516,365836,321200
935,517,486,186629,9549,366322,295400
936,551,526,186103,9549,366848,293700
937,524,481,185585,9586,367329,359200
938,526,491,185046,9634,367820,357600
939,536,468,184506,9706,368288,329200
940,491,542,184026,9644,368830,403700
941,523,512,183498,9660,369342,318800
942,478,536,183008,9614,369878,295300
943,534,476,182487,9659,370354,397300
944,532,520,181941,9685,370874,359800
945,472,503,181466,9657,371377,400200
946,524,488,180949,9686,371865,292500
947,497,544,180450,9641,372409,314400
948,524,487,179935,9669,372896,279000
949,465,520,179469,9615,373416,307800
950,509,512,178958,9614,373928,271100
951,495,492,178454,9626,374420,251800
952,483,485,177989,9606,374905,295700
953,538,483,177453,9659,375388,292900
954,509,481,176939,9692,375869,302400
955,513,496,176408,9727,376365,276900
956,519,521,175884,9730,376886,341000
957,528,534,175362,9718,377420,271700
958,478,453,174893,9734,377873,279900
959,503,506,174387,9734,378379,299500
960,483,463,173902,9756,378842,349300
961,464,526,173433,9699,379368,366400
962,554,550,172886,9696,379918,283000
963,502,520,172371,9691,380438,265000
964,538,505,171853,9704,380943,264200
965,494,503,171348,9706,381446,262000
966,495,464,170861,9729,381910,299800
967,507,504,170339,9747,382414,275900
968,496,450,169845,9791,382864,257900
969,481,510,169359,9767,383374,263700
970,470,482,168885,9759,383856,254600
971,498,502,168399,9743,384358,400100
972,467,488,167951,9703,384846,294900
973,516,560,167419,9675,385406,274500
974,508,507,166916,9671,385913,332000
975,512,473,166398,9716,386386,281800
976,454,533,165922,9659,386919,286400
977,509,541,165436,9604,387460,261600
978,497,471,164965,9604,387931,245500
979,496,495,164450,9624,388426,284300
980,507,515,163940,9619,388941,282000
981,486,499,163453,9607,389440,234900
982,498,513,162943,9604,389953,293300
983,485,463,162464,9620,390416,336700
984,477,502,161984,9598,390918,256400
985,490,510,161490,9582,391428,248500
986,548,510,160962,9600,391938,269000
987,485,498,160465,9599,392436,312600
988,470,489,159992,9583,392925,263400
989,479,509,159511,9555,393434,276100
990,488,506,159043,9517,393940,333200
991,477,494,158556,9510,394434,331200
992,487,467,158050,9549,394901,305000
993,489,540,157581,9478,395441,293100
994,468,475,157116,9468,395916,279600
995,480,475,156612,9497,396391,285400
996,479,491,156150,9468,396882,294500
997,481,491,155677,9450,397373,284700
998,504,474,155172,9481,397847,263300
999,469,478,154684,9491,398325,330400
1000,477,472,154228,9475,398797,301400
1001,482,482,153743,9478,399279,292700
1002,489,483,153244,9494,399762,324200
1003,485,524,152767,9447,400286,317700
1004,516,497,152270,9447,400783,261700
1005,501,505,151735,9477,401288,270200
1006,476,473,151271,9468,401761,341700
1007,460,506,150789,9444,402267,271800
1008,481,466,150332,9435,402733,272900
1009,492,472,149836,9459,403205,377300
1010,453,505,149379,9411,403710,314600
1011,466,493,148921,9376,404203,255800
1012,454,499,148455,9343,404702,297700
1013,458,478,147993,9327,405180,264200
1014,459,477,147536,9307,405657,271600
1015,522,463,147017,9363,406120,268100
1016,452,474,146566,9340,406594,320200
1017,464,465,146113,9328,407059,274500
1018,443,486,145645,9310,407545,302800
1019,475,489,145197,9269,408034,308600
1020,470,498,144708,9260,408532,279000
1021,465,479,144247,9242,409011,323900
1022,465,491,143789,9209,409502,294200
1023,484,453,143288,9257,409955,272100
1024,447,466,142850,9229,410421,260600
1025,458,439,142394,9246,410860,281000
1026,457,468,141935,9237,411328,291000
1027,508,495,141450,9227,411823,319600
1028,439,469,140987,9221,412292,312900
1029,420,454,140547,9207,412746,286400
1030,468,437,140109,9208,413183,294800
1031,471,472,139643,9202,413655,271100
1032,452,496,139183,9166,414151,276100
1033,479,477,138709,9163,414628,288000
1034,421,456,138276,9140,415084,289300
1035,452,492,137819,9105,415576,278200
1036,468,472,137358,9094,416048,300600
1037,455,455,136908,9089,416503,265100
1038,389,477,136513,9007,416980,249600
1039,429,464,136092,8964,417444,264900
1040,441,441,135643,8972,417885,275900
1041,441,450,135213,8952,418335,243400
1042,442,444,134763,8958,418779,252400
1043,433,444,134335,8942,419223,244400
1044,448,466,133877,8934,419689,267300
1045,435,427,133435,8949,420116,243900
1046,434,475,133008,8901,420591,301300
1047,456,457,132562,8890,421048,364000
1048,471,450,132092,8910,421498,261300
1049,454,420,131635,8947,421918,268000
1050,386,461,131223,8898,422379,270200
1051,472,429,130770,8922,422808,253700
1052,453,499,130304,8889,423307,240800
1053,411,480,129909,8804,423787,276100
1054,394,439,129515,8759,424226,248900
1055,453,459,129058,8757,424685,240200
1056,398,422,128655,8738,425107,226300
1057,392,448,128272,8673,425555,263200
1058,435,450,127842,8653,426005,280000
1059,401,466,127430,8599,426471,264200
1060,422,457,127021,8551,426928,255400
1061,412,450,126597,8525,427378,251200
1062,391,439,126200,8483,427817,289600
1063,402,378,125793,8512,428195,255800
1064,431,434,125372,8499,428629,266100
1065,427,432,124955,8484,429061,274700
1066,396,431,124558,8450,429492,361000
1067,425,407,124129,8472,429899,269800
1068,444,484,123679,8438,430383,278800
1069,406,419,123264,8434,430802,277100
1070,405,445,122867,8386,431247,231600
1071,419,437,122465,8351,431684,267100
1072,396,426,122051,8339,432110,272700
1073,405,416,121651,8323,432526,226900
1074,421,443,121219,8312,432969,234800
1075,409,425,120825,8281,433394,245700
1076,403,392,120405,8309,433786,281600
1077,445,438,119962,8314,434224,243300
1078,438,416,119544,8316,434640,220600
1079,387,445,119148,8267,435085,242900
1080,356,419,118771,8225,435504,258000
1081,409,429,118380,8187,435933,250100
1082,338,376,118042,8149,436309,248800
1083,364,410,117673,8108,436719,254700
1084,372,421,117291,8069,437140,286300
1085,382,366,116926,8068,437506,256700
1086,386,407,116540,8047,437913,248900
1087,356,408,116180,7999,438321,299000
1088,399,451,115779,7949,438772,310300
1089,392,400,115386,7942,439172,288000
1090,396,377,115014,7937,439549,255100
1091,374,395,114611,7945,439944,285300
1092,367,399,114255,7902,440343,237600
1093,369,410,113883,7864,440753,255300
1094,358,423,113507,7817,441176,219000
1095,393,415,113125,7784,441591,220100
1096,338,414,112785,7710,442005,230700
1097,369,366,112423,7706,442371,254600
1098,343,388,112078,7663,442759,242700
1099,365,421,111707,7613,443180,287500
1100,373,389,111335,7596,443569,244800
1101,346,398,110997,7536,443967,255600
1102,360,383,110624,7526,444350,266000
1103,389,397,110243,7510,444747,265600
1104,370,362,109878,7513,445109,265900
1105,338,367,109538,7486,445476,267400
1106,395,380,109162,7482,445856,283000
1107,357,383,108780,7481,446239,384800
1108,388,389,108395,7477,446628,327900
1109,361,381,108039,7452,447009,269000
1110,352,390,107693,7408,447399,266500
1111,373,384,107311,7406,447783,252800
1112,355,378,106959,7380,448161,241200
1113,345,417,106605,7317,448578,237000
1114,357,373,106237,7312,448951,255700
1115,374,394,105885,7270,449345,223800
1116,363,375,105523,7257,449720,227900
1117,366,382,105147,7251,450102,249300
1118,353,390,104796,7212,450492,211900
1119,378,386,104423,7199,450878,232800
1120,346,381,104073,7168,451259,251400
1121,359,384,103710,7147,451643,264500
1122,341,344,103371,7142,451987,223300
1123,368,382,103001,7130,452369,262700
1124,364,361,102651,7119,452730,268400
1125,351,401,102274,7095,453131,296600
1126,331,372,101963,7034,453503,222900
1127,322,356,101629,7012,453859,259400
1128,369,384,101271,6986,454243,368900
1129,379,387,100880,6990,454630,290100
1130,352,334,100559,6977,454964,253800
1131,364,358,100175,7003,455322,235100
1132,374,371,99794,7013,455693,253200
1133,363,377,99449,6981,456070,247600
1134,381,355,99051,7024,456425,228300
1135,357,340,98698,7037,456765,251600
1136,347,345,98333,7057,457110,257200
1137,351,346,97981,7063,457456,233900
1138,353,378,97644,7022,457834,217400
1139,375,376,97274,7016,458210,292100
1140,338,354,96931,7005,458564,270300
1141,330,347,96593,6996,458911,254000
1142,339,339,96267,6983,459250,263500
1143,350,397,95916,6937,459647,255800
1144,348,354,95571,6928,460001,261800
1145,358,341,95212,6946,460342,260900
1146,331,338,94879,6941,460680,262900
1147,355,345,94522,6953,461025,262600
1148,313,332,94207,6936,461357,258100
1149,303,337,93892,6914,461694,308700
1150,353,347,93540,6919,462041,270200
1151,349,348,93208,6903,462389,217600
1152,372,365,92823,6923,462754,272500
1153,324,384,92505,6857,463138,295400
1154,283,334,92206,6822,463472,269100
1155,328,399,91878,6751,463871,260800
1156,334,384,91564,6681,464255,233900
1157,353,335,91205,6705,464590,259100
1158,327,332,90875,6703,464922,265700
1159,312,358,90565,6655,465280,269600
1160,317,318,90243,6659,465598,234500
1161,326,326,89932,6644,465924,247300
1162,331,345,89597,6634,466269,267900
1163,317,354,89268,6609,466623,235600
1164,326,361,88952,6564,466984,214600
1165,309,360,88632,6524,467344,246200
1166,333,319,88301,6536,467663,249000
1167,328,304,87973,6560,467967,285800
1168,279,341,87677,6515,468308,371500
1169,317,364,87389,6439,468672,270200
1170,313,367,87063,6398,469039,302600
1171,298,338,86763,6360,469377,252100
1172,335,332,86427,6364,469709,250400
1173,338,296,86115,6380,470005,267100
1174,331,333,85772,6390,470338,231500
1175,302,347,85461,6354,470685,242600
1176,307,341,85149,6325,471026,252300
1177,336,338,84814,6322,471364,272300
1178,314,314,84500,6322,471678,227500
1179,310,332,84204,6286,472010,224100
1180,292,318,83912,6260,472328,248400
1181,317,333,83583,6256,472661,251000
1182,306,333,83284,6222,472994,234800
1183,310,280,82968,6258,473274,211600
1184,330,348,82634,6244,473622,236300
1185,313,337,82309,6232,473959,256500
1186,304,337,82022,6182,474296,243800
1187,304,328,81728,6148,474624,225600
1188,327,338,81385,6153,474962,241500
1189,302,320,81072,6146,475282,271000
1190,280,334,80809,6075,475616,243400
1191,311,335,80497,6052,475951,341900
1192,330,305,80183,6061,476256,249000
1193,325,327,79857,6060,476583,275700
1194,336,302,79524,6091,476885,258200
1195,311,298,79189,6128,477183,283900
1196,328,314,78864,6139,477497,262600
1197,283,321,78581,6101,477818,220700
1198,291,292,78297,6093,478110,277300
1199,334,312,77962,6116,478422,627900
1200,284,323,77671,6084,478745,605800
1201,297,322,77383,6050,479067,878800
1202,309,309,77077,6047,479376,626500
1203,297,276,76791,6057,479652,681700
1204,306,318,76459,6071,479970,937600
1205,293,310,76170,6050,480280,530500
1206,308,309,75871,6040,480589,728000
1207,335,319,75536,6056,480908,454600
1208,304,306,75234,6052,481214,287000
1209,327,337,74913,6036,481551,242900
1210,328,330,74577,6042,481881,247900
1211,326,334,74259,6026,482215,252100
1212,308,316,73935,6034,482531,256600
1213,275,334,73660,5975,482865,228400
1214,287,304,73366,5965,483169,226100
1215,292,300,73097,5934,483469,252300
1216,339,282,72748,6001,483751,253300
1217,324,324,72415,6010,484075,264600
1218,310,320,72107,5998,484395,234200
1219,300,310,71820,5975,484705,287100
1220,302,325,71516,5954,485030,277500
1221,320,322,71194,5954,485352,253100
1222,303,313,70888,5947,485665,206900
1223,263,305,70617,5913,485970,278000
1224,290,302,70339,5889,486272,260800
1225,293,308,70034,5886,486580,225700
1226,277,296,69758,5866,486876,247500
1227,273,330,69485,5809,487206,269400
1228,327,268,69157,5869,487474,254000
1229,272,301,68879,5846,487775,263200
1230,265,301,68617,5807,488076,259400
1231,276,310,68335,5779,488386,243000
1232,286,271,68059,5784,488657,243100
1233,258,323,67807,5713,488980,219200
1234,302,304,67503,5713,489284,232300
1235,292,293,67207,5716,489577,252600
1236,291,287,66919,5717,489864,249100
1237,270,300,66647,5689,490164,217200
1238,262,334,66374,5628,490498,242300
1239,243,303,66138,5561,490801,238800
1240,259,287,65868,5544,491088,231900
1241,263,277,65610,5525,491365,232600
1242,253,291,65356,5488,491656,241900
1243,288,270,65093,5481,491926,247800
1244,289,264,64790,5520,492190,231700
1245,294,275,64505,5530,492465,222100
1246,281,292,64220,5523,492757,221900
1247,282,249,63946,5548,493006,241700
1248,291,311,63638,5545,493317,272100
1249,300,291,63361,5531,493608,274900
1250,292,294,63056,5542,493902,278400
1251,284,292,62767,5539,494194,325800
1252,284,325,62487,5494,494519,277400
1253,249,285,62231,5465,494804,288200
1254,256,268,61962,5466,495072,272800
1255,276,273,61702,5453,495345,273200
1256,265,266,61433,5456,495611,311200
1257,274,275,61161,5453,495886,319800
1258,295,275,60859,5480,496161,303600
1259,229,267,60630,5442,496428,236300
1260,291,274,60355,5443,496702,265000
1261,257,298,60096,5404,497000,308600
1262,248,285,59844,5371,497285,326200
1263,254,266,59582,5367,497551,254900
1264,273,275,59314,5360,497826,298600
1265,238,250,59080,5344,498076,302900
1266,264,281,58807,5336,498357,241100
1267,276,257,58532,5354,498614,258600
1268,225,272,58297,5317,498886,261900
1269,248,273,58054,5287,499159,254600
1270,258,322,57803,5216,499481,242000
1271,251,274,57552,5193,499755,256500
1272,228,250,57319,5176,500005,310900
1273,239,250,57081,5164,500255,1152600
1274,260,264,56820,5161,500519,305100
1275,250,251,56581,5149,500770,310400
1276,242,276,56327,5127,501046,274800
1277,260,267,56080,5107,501313,282000
1278,247,263,55822,5102,501576,251500
1279,239,246,55578,5100,501822,247100
1280,246,275,55335,5068,502097,274700
1281,239,250,55095,5058,502347,274000
1282,231,235,54866,5052,502582,246400
1283,245,287,54619,5012,502869,246200
1284,231,257,54390,4984,503126,249900
1285,257,225,54137,5012,503351,244100
1286,227,247,53906,4996,503598,307200
1287,238,279,53662,4961,503877,266900
1288,257,243,53416,4964,504120,249500
1289,242,267,53177,4936,504387,264700
1290,253,242,52907,4964,504629,306400
1291,229,227,52688,4956,504856,234900
1292,239,256,52434,4954,505112,256200
1293,264,238,52191,4959,505350,275300
1294,259,227,51934,4989,505577,311700
1295,260,288,51673,4962,505865,246800
1296,213,264,51445,4926,506129,257100
1297,247,274,51211,4886,506403,337300
1298,256,247,50954,4896,506650,293500
1299,233,275,50719,4856,506925,282600
1300,249,262,50469,4844,507187,261400
1301,236,240,50222,4851,507427,270200
1302,211,244,50022,4807,507671,248800
1303,216,236,49807,4786,507907,304100
1304,231,227,49574,4792,508134,280800
1305,220,256,49350,4760,508390,244600
1306,207,274,49139,4697,508664,222900
1307,233,214,48918,4704,508878,252400
1308,232,222,48674,4726,509100,273700
1309,223,228,48453,4719,509328,248100
1310,206,222,48258,4692,509550,245600
1311,232,215,48019,4716,509765,257900
1312,241,249,47773,4713,510014,277700
1313,212,217,47566,4703,510231,251300
1314,227,250,47338,4681,510481,250200
1315,236,251,47101,4667,510732,295200
1316,217,222,46883,4663,510954,251300
1317,221,244,46666,4636,511198,219500
1318,203,226,46451,4625,511424,272900
1319,232,227,46240,4609,511651,256600
1320,215,228,46004,4617,511879,273200
1321,195,230,45824,4567,512109,273000
1322,217,219,45604,4568,512328,252500
1323,211,235,45385,4552,512563,275200
1324,183,235,45202,4500,512798,243100
1325,197,232,45016,4454,513030,225600
1326,220,252,44795,4423,513282,266200
1327,202,226,44581,4411,513508,259900
1328,223,235,44360,4397,513743,245400
1329,211,218,44151,4388,513961,214900
1330,207,223,43939,4377,514184,260800
1331,203,244,43748,4324,514428,309300
1332,212,246,43520,4306,514674,233000
1333,197,205,43329,4292,514879,230400
1334,190,238,43143,4240,515117,263600
1335,205,185,42932,4266,515302,287200
1336,179,225,42748,4225,515527,257300
1337,164,236,42595,4142,515763,228400
1338,199,219,42391,4127,515982,261500
1339,181,251,42209,4058,516233,292200
1340,158,206,42057,4004,516439,263200
1341,164,199,41889,3973,516638,284500
1342,174,214,41716,3932,516852,270000
1343,177,184,41544,3920,517036,238600
1344,181,188,41349,3927,517224,275200
1345,181,175,41177,3924,517399,286000
1346,217,200,40953,3948,517599,276200
1347,184,203,40771,3927,517802,246100
1348,173,231,40606,3861,518033,246300
1349,196,208,40412,3847,518241,285600
1350,207,199,40207,3853,518440,264000
1351,152,198,40046,3816,518638,246800
1352,195,190,39853,3819,518828,238500
1353,183,183,39673,3816,519011,235100
1354,178,185,39487,3817,519196,259000
1355,176,205,39313,3786,519401,226100
1356,183,208,39132,3759,519609,271900
1357,175,201,38963,3727,519810,291200
1358,181,172,38777,3741,519982,271000
1359,181,181,38596,3741,520163,356600
1360,179,194,38403,3740,520357,288200
1361,194,218,38216,3709,520575,333700
1362,166,191,38055,3679,520766,225700
1363,187,166,37862,3706,520932,294300
1364,186,190,37682,3696,521122,270600
1365,184,186,37498,3694,521308,221900
1366,164,180,37330,3682,521488,233900
1367,189,191,37140,3681,521679,256300
1368,153,186,36986,3649,521865,292500
1369,160,181,36825,3629,522046,236700
1370,170,193,36655,3606,522239,243000
1371,165,183,36491,3587,522422,249500
1372,151,175,36342,3561,522597,285800
1373,178,199,36163,3541,522796,234700
1374,160,186,36006,3512,522982,253700
1375,164,174,35839,3505,523156,268400
1376,166,192,35672,3480,523348,257100
1377,162,194,35507,3451,523542,223400
1378,141,166,35364,3428,523708,266900
1379,157,190,35210,3392,523898,275100
1380,151,159,35061,3382,524057,287200
1381,154,171,34914,3358,524228,295900
1382,136,169,34775,3328,524397,272700
1383,159,169,34613,3321,524566,318400
1384,164,164,34448,3322,524730,301300
1385,146,181,34303,3286,524911,312000
1386,158,177,34150,3262,525088,274500
1387,134,148,34008,3256,525236,249100
1388,158,177,33856,3231,525413,278200
1389,157,172,33702,3213,525585,332200
1390,162,162,33524,3229,525747,342400
1391,161,142,33373,3238,525889,260800
1392,139,171,33228,3212,526060,275500
1393,134,155,33096,3189,526215,239900
1394,144,155,32954,3176,526370,235300
1395,140,165,32807,3158,526535,280500
1396,154,166,32658,3141,526701,283600
1397,145,175,32516,3108,526876,250500
1398,153,143,32360,3121,527019,231400
1399,136,167,32226,3088,527186,318300
1400,123,171,32100,3043,527357,322700
1401,145,161,31963,3019,527518,269800
1402,131,145,31829,3008,527663,257800
1403,118,135,31701,3001,527798,305700
1404,146,151,31563,2988,527949,284900
1405,158,162,31406,2983,528111,258700
1406,141,169,31268,2952,528280,264500
1407,143,150,31111,2959,528430,291000
1408,136,144,30981,2945,528574,239500
1409,159,142,30826,2958,528716,241800
1410,129,166,30701,2917,528882,276700
1411,149,152,30551,2915,529034,278000
1412,149,161,30399,2906,529195,339300
1413,134,129,30273,2903,529324,235700
1414,124,139,30139,2898,529463,232000
1415,145,151,29987,2899,529614,253000
1416,153,152,29841,2893,529766,253200
1417,132,154,29711,2869,529920,264100
1418,137,174,29573,2833,530094,242600
1419,143,152,29433,2821,530246,340900
1420,157,153,29279,2822,530399,250700
1421,144,136,29129,2836,530535,241300
1422,139,164,28987,2814,530699,199800
1423,118,165,28875,2761,530864,218300
1424,114,152,28751,2733,531016,227600
1425,127,138,28621,2725,531154,244300
1426,146,138,28490,2718,531292,252000
1427,138,149,28348,2711,531441,224200
1428,128,128,28219,2712,531569,234400
1429,136,146,28086,2699,531715,212500
1430,142,133,27942,2710,531848,219000
1431,137,132,27808,2712,531980,257100
1432,148,147,27662,2711,532127,225000
1433,106,126,27547,2700,532253,245500
1434,119,138,27425,2684,532391,235800
1435,130,128,27293,2688,532519,232800
1436,126,151,27174,2656,532670,193200
1437,117,126,27060,2644,532796,232800
1438,134,127,26923,2654,532923,256600
1439,121,157,26800,2620,533080,257700
1440,146,126,26656,2638,533206,240400
1441,137,150,26521,2623,533356,313900
1442,142,142,26378,2624,533498,238500
1443,151,137,26233,2632,533635,211400
1444,125,135,26105,2625,533770,360600
1445,138,148,25963,2619,533918,242500
1446,150,151,25821,2610,534069,219200
1447,137,142,25683,2606,534211,232500
1448,137,122,25533,2634,534333,263200
1449,137,129,25404,2634,534462,229900
1450,158,145,25246,2647,534607,209900
1451,158,132,25093,2668,534739,205000
1452,132,152,24960,2649,534891,216000
1453,132,147,24819,2643,535038,220000
1454,141,134,24687,2641,535172,243400
1455,137,141,24547,2640,535313,205400
1456,142,127,24395,2665,535440,217200
1457,146,120,24266,2674,535560,225700
1458,133,114,24132,2694,535674,208200
1459,132,155,23988,2683,535829,197300
1460,133,128,23858,2685,535957,201500
1461,113,148,23741,2654,536105,239400
1462,149,133,23595,2667,536238,216500
1463,128,146,23472,2644,536384,217800
1464,119,124,23350,2642,536508,339600
1465,133,142,23216,2634,536650,219200
1466,141,144,23078,2628,536794,375200
1467,120,140,22955,2611,536934,317500
1468,142,123,22818,2625,537057,243100
1469,121,131,22695,2617,537188,219400
1470,137,141,22559,2612,537329,206300
1471,108,143,22438,2590,537472,199900
1472,120,128,22327,2573,537600,228700
1473,124,129,22200,2571,537729,235100
1474,104,126,22094,2551,537855,261900
1475,123,133,21978,2534,537988,227800
1476,123,128,21855,2529,538116,331800
1477,101,127,21750,2507,538243,244300
1478,119,125,21637,2495,538368,221000
1479,96,122,21527,2483,538490,204400
1480,109,117,21427,2466,538607,208600
1481,105,124,21323,2446,538731,219200
1482,98,119,21217,2433,538850,222600
1483,93,130,21122,2398,538980,206900
1484,101,122,21021,2377,539102,254900
1485,82,89,20944,2365,539191,223900
1486,121,120,20828,2361,539311,241300
1487,108,113,20713,2363,539424,312500
1488,104,123,20609,2344,539547,264500
1489,122,123,20486,2344,539670,223500
1490,106,114,20386,2330,539784,201700
1491,125,138,20255,2323,539922,212300
1492,116,117,20144,2317,540039,231600
1493,93,124,20050,2287,540163,222100
1494,76,119,19970,2248,540282,247300
1495,113,113,19868,2237,540395,240400
1496,101,105,19756,2244,540500,217700
1497,110,121,19652,2227,540621,197800
1498,115,120,19540,2219,540741,189300
1499,129,111,19405,2243,540852,237900
1500,109,117,19304,2227,540969,205300
1501,94,126,19210,2195,541095,199200
1502,90,118,19106,2181,541213,235300
1503,109,120,19002,2165,541333,231300
1504,103,111,18893,2163,541444,246700
1505,95,119,18799,2138,541563,241400
1506,101,93,18706,2138,541656,229600
1507,123,128,18584,2132,541784,207000
1508,101,94,18488,2134,541878,229700
1509,106,104,18379,2139,541982,215000
1510,108,88,18271,2159,542070,282200
1511,89,100,18175,2155,542170,385600
1512,81,106,18094,2130,542276,236300
1513,98,105,17998,2121,542381,236200
1514,95,109,17907,2103,542490,250100
1515,115,108,17794,2108,542598,228600
1516,90,107,17701,2094,542705,215500
1517,107,104,17590,2101,542809,203200
1518,110,115,17483,2093,542924,275300
1519,99,126,17383,2067,543050,217800
1520,105,106,17273,2071,543156,216500
1521,98,96,17183,2065,543252,218000
1522,100,103,17084,2061,543355,282800
1523,89,73,16986,2086,543428,282500
1524,91,138,16902,2032,543566,291700
1525,65,102,16834,1998,543668,270200
1526,69,98,16759,1975,543766,379200
1527,81,86,16682,1966,543852,214200
1528,91,110,16592,1946,543962,201300
1529,78,107,16510,1921,544069,216500
1530,88,98,16425,1908,544167,221300
1531,91,111,16335,1887,544278,188000
1532,70,110,16267,1845,544388,243600
1533,63,82,16205,1825,544470,205900
1534,91,89,16112,1829,544559,244400
1535,66,81,16044,1816,544640,217100
1536,76,92,15968,1800,544732,220400
1537,90,75,15876,1817,544807,229800
1538,83,99,15795,1799,544906,214600
1539,75,87,15722,1785,544993,265500
1540,71,70,15643,1794,545063,249600
1541,87,97,15559,1781,545160,223200
1542,79,100,15482,1758,545260,221700
1543,69,103,15417,1720,545363,253400
1544,66,105,15345,1687,545468,311800
1545,88,91,15263,1678,545559,258500
1546,74,93,15182,1666,545652,268200
1547,67,81,15114,1653,545733,268000
1548,74,101,15048,1618,545834,228900
1549,63,86,14983,1597,545920,204700
1550,65,84,14916,1580,546004,266100
1551,87,92,14828,1576,546096,223900
1552,76,88,14752,1564,546184,228300
1553,75,85,14676,1555,546269,222700
1554,76,76,14600,1555,546345,300000
1555,60,102,14539,1514,546447,235300
1556,71,67,14472,1514,546514,230400
1557,49,84,14421,1481,546598,245300
1558,58,84,14364,1454,546682,226800
1559,51,67,14307,1444,546749,268700
1560,61,71,14251,1429,546820,248600
1561,56,71,14194,1415,546891,245600
1562,83,73,14109,1427,546964,231200
1563,52,59,14054,1423,547023,249300
1564,59,72,13995,1410,547095,263700
1565,46,63,13949,1393,547158,287800
1566,55,67,13897,1378,547225,200400
1567,52,63,13845,1367,547288,221900
1568,53,66,13793,1353,547354,194100
1569,56,82,13739,1325,547436,210400
1570,58,60,13683,1321,547496,248900
1571,54,68,13625,1311,547564,224400
1572,61,67,13562,1307,547631,207100
1573,47,73,13518,1278,547704,217800
1574,53,68,13463,1265,547772,209700
1575,57,73,13408,1247,547845,198100
1576,55,71,13353,1231,547916,210200
1577,58,71,13300,1213,547987,234500
1578,44,65,13247,1201,548052,251200
1579,65,68,13186,1194,548120,253000
1580,52,71,13134,1175,548191,198100
1581,38,62,13095,1152,548253,232800
1582,49,61,13043,1143,548314,314000
1583,50,44,12998,1144,548358,215500
1584,52,63,12940,1139,548421,204500
1585,41,50,12903,1126,548471,212500
1586,44,61,12858,1110,548532,231000
1587,49,68,12810,1090,548600,261300
1588,43,62,12773,1065,548662,233300
1589,39,48,12727,1063,548710,229800
1590,48,49,12680,1061,548759,196100
1591,54,58,12623,1060,548817,206100
1592,40,54,12586,1043,548871,236800
1593,38,44,12544,1041,548915,202000
1594,39,43,12508,1034,548958,208800
1595,31,56,12478,1008,549014,244900
1596,44,40,12433,1013,549054,250400
1597,41,60,12391,995,549114,237000
1598,33,63,12359,964,549177,229700
1599,30,45,12328,950,549222,202800
1600,32,43,12297,938,549265,235700
1601,44,49,12258,928,549314,245100
1602,46,43,12206,937,549357,259300
1603,28,51,12175,917,549408,215800
1604,34,47,12145,900,549455,214200
1605,38,32,12106,907,549487,186200
1606,54,40,12057,916,549527,210400
1607,28,54,12022,897,549581,232600
1608,38,49,11987,883,549630,202400
1609,46,40,11940,890,549670,229100
1610,40,44,11903,883,549714,229800
1611,32,53,11868,865,549767,225100
1612,44,57,11824,852,549824,193200
1613,37,43,11786,847,549867,194400
1614,42,37,11742,854,549904,213300
1615,36,47,11708,841,549951,229000
1616,41,39,11672,838,549990,247900
1617,45,37,11625,848,550027,191800
1618,36,52,11588,833,550079,244800
1619,47,55,11541,825,550134,233300
1620,32,37,11507,822,550171,217500
1621,40,47,11468,814,550218,236900
1622,29,34,11442,806,550252,220100
1623,30,41,11407,800,550293,185200
1624,29,53,11383,771,550346,206100
1625,38,39,11342,773,550385,287600
1626,35,41,11307,767,550426,205000
1627,29,32,11277,765,550458,208000
1628,48,38,11230,774,550496,191200
1629,38,33,11191,780,550529,234500
1630,29,49,11162,760,550578,209900
1631,36,51,11126,745,550629,222900
1632,38,35,11091,745,550664,245300
1633,35,53,11054,729,550717,260100
1634,24,36,11029,718,550753,223100
1635,34,38,10994,715,550791,248200
1636,24,38,10973,698,550829,213600
1637,37,32,10934,705,550861,210700
1638,36,34,10901,704,550895,209300
1639,32,25,10871,709,550920,209800
1640,21,35,10843,702,550955,216000
1641,26,37,10819,689,550992,214600
1642,38,41,10782,685,551033,224200
1643,26,36,10754,677,551069,200800
1644,25,24,10728,679,551093,229300
1645,23,38,10704,665,551131,238200
1646,41,37,10672,660,551168,243800
1647,23,26,10642,664,551194,203400
1648,26,22,10615,669,551216,199700
1649,28,32,10590,662,551248,199500
1650,22,38,10565,649,551286,239600
1651,20,34,10547,633,551320,212900
1652,26,43,10519,618,551363,206300
1653,28,35,10493,609,551398,216200
1654,28,30,10465,607,551428,202000
1655,23,30,10442,600,551458,268300
1656,30,27,10411,604,551485,207300
1657,20,36,10391,588,551521,209100
1658,24,31,10368,580,551552,232200
1659,19,33,10347,568,551585,219500
1660,17,27,10329,559,551612,189600
1661,14,30,10315,543,551642,196100
1662,22,28,10296,534,551670,233800
1663,22,25,10277,528,551695,309300
1664,22,31,10253,521,551726,236400
1665,17,27,10234,513,551753,202700
1666,18,32,10217,498,551785,208300
1667,20,22,10198,495,551807,214500
1668,14,38,10182,473,551845,222600
1669,13,27,10168,460,551872,208300
1670,19,26,10149,453,551898,186900
1671,17,28,10135,439,551926,208000
1672,14,21,10118,435,551947,195200
1673,15,18,10103,432,551965,189300
1674,13,25,10090,420,551990,191400
1675,11,22,10080,408,552012,227100
1676,10,23,10066,399,552035,220300
1677,8,8,10062,395,552043,222500
1678,12,26,10050,381,552069,205700
1679,10,19,10039,373,552088,216600
1680,14,19,10026,367,552107,218400
1681,22,23,10005,365,552130,217200
1682,17,23,9985,362,552153,200500
1683,13,15,9974,358,552168,192100
1684,6,13,9965,354,552181,206400
1685,10,20,9956,343,552201,223700
1686,17,14,9941,344,552215,218700
1687,8,12,9931,342,552227,207000
1688,8,21,9922,330,552248,205700
1689,8,11,9917,324,552259,185600
1690,8,19,9909,313,552278,209500
1691,8,15,9898,309,552293,251500
1692,14,10,9885,312,552303,257300
1693,9,16,9877,304,552319,215800
1694,13,18,9863,300,552337,219000
1695,19,10,9845,308,552347,202700
1696,14,16,9831,306,552363,215000
1697,11,14,9820,303,552377,222600
1698,12,18,9810,295,552395,218800
1699,18,22,9791,292,552417,224700
1700,13,16,9776,291,552433,256700
1701,13,12,9763,292,552445,237700
1702,12,21,9753,281,552466,209200
1703,17,16,9736,282,552482,196800
1704,18,25,9718,275,552507,194600
1705,16,12,9699,282,552519,201900
1706,7,14,9693,274,552533,212100
1707,14,17,9680,270,552550,211300
1708,16,18,9666,266,552568,221200
1709,11,10,9651,271,552578,214600
1710,10,17,9642,263,552595,199400
1711,15,9,9627,269,552604,210800
1712,8,18,9617,261,552622,207000
1713,8,11,9610,257,552633,240400
1714,10,8,9602,257,552641,244400
1715,6,8,9595,256,552649,196100
1716,5,12,9590,249,552661,216700
1717,13,7,9578,254,552668,214900
1718,16,16,9563,253,552684,223600
1719,14,12,9546,258,552696,218900
1720,10,8,9537,259,552704,210800
1721,14,6,9525,265,552710,194600
1722,12,9,9512,269,552719,196700
1723,12,15,9501,265,552734,178500
1724,13,20,9488,258,552754,209000
1725,21,8,9469,269,552762,221500
1726,11,11,9454,273,552773,222500
1727,10,18,9444,265,552791,202800
1728,10,20,9435,254,552811,219800
1729,11,15,9423,251,552826,195500
1730,10,17,9412,245,552843,200300
1731,6,13,9407,237,552856,197600
1732,14,15,9394,235,552871,207400
1733,7,10,9387,232,552881,217700
1734,11,10,9375,234,552891,210300
1735,10,18,9365,226,552909,207200
1736,13,15,9353,223,552924,249500
1737,7,11,9344,221,552935,232600
1738,15,13,9329,223,552948,200900
1739,9,8,9321,223,552956,219400
1740,10,15,9310,219,552971,255000
1741,10,9,9300,220,552980,212300
1742,5,15,9295,210,552995,211300
1743,5,6,9289,210,553001,213900
1744,11,9,9281,209,553010,184300
1745,10,12,9274,204,553022,204100
1746,6,9,9264,205,553031,201900
1747,10,10,9254,205,553041,202400
1748,9,10,9244,205,553051,197600
1749,9,11,9234,204,553062,238000
1750,12,8,9226,204,553070,333400
1751,11,6,9212,212,553076,231600
1752,5,14,9207,203,553090,406600
1753,6,14,9203,193,553104,263700
1754,8,7,9197,192,553111,210500
1755,6,10,9186,193,553121,201300
1756,13,14,9174,191,553135,187900
1757,7,17,9167,181,553152,249100
1758,7,5,9159,184,553157,196100
1759,8,8,9154,181,553165,183800
1760,12,12,9141,182,553177,199400
1761,3,14,9136,173,553191,193400
1762,5,11,9132,166,553202,202900
1763,9,7,9124,167,553209,221700
1764,10,3,9115,173,553212,218300
1765,6,8,9107,173,553220,212200
1766,9,10,9101,169,553230,222500
1767,3,10,9094,166,553240,246200
1768,2,5,9093,162,553245,196800
1769,7,9,9087,159,553254,216600
1770,6,11,9080,155,553265,190400
1771,5,12,9074,149,553277,185900
1772,1,4,9073,146,553281,194300
1773,6,10,9068,141,553291,252700
1774,7,11,9060,138,553302,224200
1775,4,6,9056,136,553308,203900
1776,7,5,9052,135,553313,202200
1777,4,6,9046,135,553319,219600
1778,1,6,9044,131,553325,226600
1779,7,11,9039,125,553336,187700
1780,2,6,9036,122,553342,200200
1781,4,4,9031,123,553346,210300
1782,6,3,9026,125,553349,226300
1783,7,6,9019,126,553355,429500
1784,8,8,9013,124,553363,798400
1785,3,4,9009,124,553367,560900
1786,3,8,9005,120,553375,472100
1787,6,8,9000,117,553383,483200
1788,4,7,8996,114,553390,1045900
1789,7,6,8989,115,553396,247400
1790,7,5,8982,117,553401,201700
1791,3,4,8977,118,553405,248200
1792,1,6,8977,112,553411,220500
1793,7,3,8970,116,553414,236000
1794,3,5,8969,112,553419,204600
1795,4,6,8963,112,553425,213500
1796,6,5,8958,112,553430,216400
1797,2,9,8955,106,553439,324600
1798,2,4,8952,105,553443,211600
1799,5,6,8947,104,553449,201800
1800,3,6,8945,100,553455,217100
1801,2,2,8943,100,553457,207700
1802,1,4,8942,97,553461,180900
1803,3,4,8938,97,553465,234200
1804,2,8,8936,91,553473,252800
1805,4,2,8933,92,553475,217700
1806,4,7,8929,89,553482,196400
1807,3,2,8926,90,553484,212500
1808,4,6,8923,87,553490,194600
1809,9,4,8914,92,553494,195600
1810,1,4,8911,91,553498,215200
1811,1,7,8911,84,553505,195200
1812,3,3,8908,84,553508,189600
1813,3,4,8905,83,553512,234100
1814,5,8,8900,80,553520,196100
1815,6,9,8894,77,553529,189900
1816,3,4,8890,77,553533,260900
1817,4,7,8887,73,553540,212900
1818,2,2,8885,73,553542,196000
1819,2,2,8883,73,553544,202600
1820,5,2,8880,74,553546,244000
1821,5,4,8873,77,553550,214400
1822,2,5,8871,74,553555,200600
1823,2,4,8869,72,553559,212200
1824,4,2,8864,75,553561,191400
1825,1,6,8863,70,553567,195800
1826,1,4,8862,67,553571,206000
1827,1,2,8861,66,553573,186600
1828,0,5,8861,61,553578,226100
1829,2,5,8859,58,553583,266000
1830,1,3,8858,56,553586,195800
1831,3,3,8855,56,553589,236600
1832,3,3,8853,55,553592,204100
1833,7,3,8845,60,553595,197500
1834,2,2,8844,59,553597,220700
1835,1,4,8842,57,553601,215200
1836,1,3,8842,54,553604,201900
1837,1,2,8840,54,553606,224800
1838,2,3,8838,53,553609,190200
1839,1,2,8837,52,553611,214500
1840,2,3,8837,49,553614,185600
1841,2,1,8833,52,553615,216200
1842,4,2,8829,54,553617,229100
1843,2,4,8828,51,553621,244300
1844,2,2,8825,52,553623,239400
1845,4,3,8821,53,553626,244300
1846,3,3,8818,53,553629,235100
1847,1,4,8818,49,553633,178100
1848,2,1,8816,50,553634,191700
1849,0,3,8815,48,553637,215700
1850,2,2,8814,47,553639,216800
1851,1,1,8812,48,553640,203200
1852,2,2,8810,48,553642,208900
1853,1,2,8809,47,553644,181900
1854,1,1,8808,47,553645,213100
1855,2,4,8806,45,553649,233000
1856,2,1,8804,46,553650,234500
1857,2,1,8802,47,553651,263600
1858,1,3,8801,45,553654,207700
1859,1,0,8801,45,553654,180400
1860,0,1,8800,45,553655,240200
1861,1,5,8799,41,553660,203900
1862,1,4,8798,38,553664,201300
1863,0,2,8798,36,553666,204400
1864,1,3,8797,34,553669,182100
1865,1,5,8796,30,553674,226900
1866,0,1,8796,29,553675,229800
1867,0,3,8796,26,553678,218600
1868,0,2,8796,24,553680,191500
1869,0,1,8796,23,553681,189400
1870,0,1,8796,22,553682,198000
1871,0,4,8796,18,553686,182800
1872,0,0,8796,18,553686,182300
1873,0,0,8796,18,553686,192600
1874,0,3,8796,15,553689,173500
1875,0,0,8796,15,553689,259000
1876,0,0,8796,15,553689,183700
1877,0,0,8796,15,553689,180300
1878,0,1,8796,14,553690,206200
1879,0,0,8796,14,553690,325800
1880,0,0,8796,14,553690,222000
1881,0,0,8796,14,553690,198100
1882,0,2,8796,12,553692,197700
1883,0,0,8796,12,553692,172500
1884,0,1,8796,11,553693,206400
1885,0,3,8796,8,553696,186100
1886,0,0,8796,8,553696,215900
1887,0,0,8796,8,553696,200900
1888,0,0,8796,8,553696,206200
1889,0,1,8796,7,553697,219900
1890,0,0,8796,7,553697,209000
1891,0,0,8796,7,553697,193700
1892,0,0,8796,7,553697,233500
1893,0,0,8796,7,553697,215900
1894,0,1,8796,6,553698,188900
1895,0,0,8796,6,553698,202000
1896,0,1,8796,5,553699,209800
1897,0,0,8796,5,553699,201900
1898,0,0,8796,5,553699,196700
1899,0,0,8796,5,553699,184100
1900,0,0,8796,5,553699,215900
1901,0,1,8796,4,553700,186600
1902,0,1,8796,3,553701,179800
1903,0,0,8796,3,553701,218100
1904,0,0,8796,3,553701,195900
1905,0,0,8796,3,553701,244000
1906,0,1,8796,2,553702,205600
1907,0,0,8796,2,553702,190200
1908,0,0,8796,2,553702,202500
1909,0,0,8796,2,553702,197800
1910,0,0,8796,2,553702,200600
1911,0,0,8796,2,553702,211400
1912,0,0,8796,2,553702,200600
1913,0,0,8796,2,553702,201000
1914,0,0,8796,2,553702,189600
1915,0,0,8796,2,553702,212700
1916,0,0,8796,2,553702,193700
1917,0,0,8796,2,553702,361600
1918,0,0,8796,2,553702,244500
1919,0,0,8796,2,553702,226600
1920,0,0,8796,2,553702,215000
1921,0,0,8796,2,553702,233800
1922,0,0,8796,2,553702,236700
1923,0,0,8796,2,553702,235200
1924,0,0,8796,2,553702,187000
1925,0,0,8796,2,553702,188100
1926,0,0,8796,2,553702,195900
1927,0,0,8796,2,553702,214600
1928,0,0,8796,2,553702,217200
1929,0,0,8796,2,553702,334200
1930,0,0,8796,2,553702,222100
1931,0,0,8796,2,553702,227800
1932,0,0,8796,2,553702,225900
1933,0,1,8796,1,553703,191700
1934,0,0,8796,1,553703,188300
1935,0,0,8796,1,553703,235000
1936,0,0,8796,1,553703,192000
1937,0,0,8796,1,553703,194300
1938,0,0,8796,1,553703,184600
1939,0,0,8796,1,553703,188000
1940,0,0,8796,1,553703,213100
1941,0,0,8796,1,553703,187200
1942,0,0,8796,1,553703,192500
1943,0,0,8796,1,553703,221600
1944,0,0,8796,1,553703,172000
1945,0,0,8796,1,553703,214700
1946,0,0,8796,1,553703,183900
1947,0,0,8796,1,553703,216400
1948,0,0,8796,1,553703,197800
1949,0,0,8796,1,553703,212400
1950,0,0,8796,1,553703,219300
1951,0,0,8796,1,553703,211800
1952,0,0,8796,1,553703,257700
1953,0,0,8796,1,553703,217200
1954,0,0,8796,1,553703,206800
1955,0,1,8796,0,553704,200100
