Tick,NewlyInfected,NewlyRecovered,TotalSusceptible,TotalInfected,TotalRecovered,StepTimeNanos
0,2,0,2249994,6,0,45285900
1,2,0,2249993,7,0,1510800
2,4,1,2249987,12,1,51467400
3,2,0,2249985,14,1,1531000
4,4,0,2249983,16,1,1394500
5,4,0,2249977,22,1,1321300
6,7,1,2249971,27,2,1370900
7,7,3,2249965,30,5,1245300
8,7,1,2249960,34,6,1316400
9,14,3,2249945,46,9,1343900
10,8,6,2249936,49,15,1343600
11,14,2,2249925,58,17,1190800
12,7,3,2249916,64,20,1083000
13,6,3,2249909,68,23,1121800
14,12,6,2249896,75,29,1062800
15,13,4,2249889,78,33,1135000
16,9,4,2249877,86,37,1138400
17,11,6,2249863,94,43,1081300
18,13,8,2249849,100,51,1054100
19,10,5,2249843,101,56,1181600
20,9,3,2249834,107,59,1082800
21,12,6,2249825,110,65,1131200
22,11,6,2249809,120,71,1394000
23,20,9,2249794,126,80,1399900
24,15,12,2249774,134,92,1446100
25,22,10,2249755,143,102,1432200
26,16,10,2249738,150,112,1385800
27,19,8,2249720,160,120,1392600
28,19,9,2249705,166,129,1292600
29,19,6,2249681,184,135,1335400
30,24,12,2249658,195,147,1330400
31,16,7,2249641,205,154,1513500
32,17,13,2249622,211,167,1609900
33,19,10,2249607,216,177,1385800
34,32,11,2249576,236,188,1453900
35,32,11,2249542,259,199,1356800
36,30,13,2249513,275,212,1386600
37,28,20,2249480,288,232,1309600
38,24,17,2249457,294,249,1332400
39,17,17,2249443,291,266,1215600
40,22,19,2249418,297,285,1675000
41,30,19,2249395,301,304,1347900
42,31,17,2249363,316,321,1225400
43,33,21,2249328,330,342,1916200
44,23,15,2249300,343,357,1211900
45,32,18,2249272,353,375,1199900
46,37,18,2249236,371,393,1229500
47,31,24,2249207,376,417,1282600
48,31,20,2249174,389,437,1262000
49,27,25,2249151,387,462,1192200
50,30,15,2249117,406,477,1119900
51,31,17,2249086,420,494,1118400
52,34,29,2249055,422,523,1122200
53,46,20,2249013,444,543,1145500
54,50,29,2248963,465,572,1218100
55,41,19,2248916,493,591,1202800
56,56,27,2248866,516,618,1187600
57,44,24,2248823,535,642,1221200
58,35,27,2248785,546,669,1222200
59,44,23,2248740,568,692,1283200
60,38,24,2248700,584,716,1215900
61,62,30,2248638,616,746,1263500
62,54,27,2248588,639,773,1157600
63,61,37,2248525,665,810,1166600
64,59,34,2248466,690,844,1160500
65,51,32,2248420,704,876,1108000
66,52,35,2248364,725,911,1116800
67,77,34,2248298,757,945,1410400
68,51,35,2248240,780,980,1251500
69,78,46,2248172,802,1026,1124500
70,68,47,2248097,830,1073,8226200
71,64,41,2248026,860,1114,1541800
72,57,47,2247970,869,1161,1623300
73,54,29,2247917,893,1190,1325000
74,56,52,2247858,900,1242,1236900
75,56,47,2247806,905,1289,1188000
76,68,49,2247735,927,1338,1180000
77,68,42,2247672,948,1380,1185200
78,61,40,2247611,969,1420,1111200
79,75,52,2247541,987,1472,1128500
80,68,58,2247466,1004,1530,1094800
81,83,43,2247387,1040,1573,1187200
82,71,57,2247309,1061,1630,1105400
83,85,57,2247232,1081,1687,1059400
84,64,45,2247169,1099,1732,1047100
85,72,53,2247091,1124,1785,1018800
86,72,67,2247027,1121,1852,1022600
87,78,53,2246946,1149,1905,1074000
88,72,58,2246872,1165,1963,1278500
89,97,69,2246785,1183,2032,1253900
90,83,60,2246687,1221,2092,1447500
91,76,66,2246617,1225,2158,1322900
92,58,60,2246560,1222,2218,1388800
93,78,73,2246480,1229,2291,1407500
94,69,60,2246412,1237,2351,1727400
95,81,62,2246330,1257,2413,1512900
96,82,67,2246250,1270,2480,1591700
97,85,70,2246159,1291,2550,1400700
98,71,68,2246090,1292,2618,1418900
99,93,63,2245997,1322,2681,1305600
100,97,67,2245903,1349,2748,1285700
101,89,68,2245815,1369,2816,1285400
102,101,74,2245711,1399,2890,1201500
103,91,74,2245620,1416,2964,1190300
104,87,61,2245545,1430,3025,1129700
105,102,75,2245436,1464,3100,1115200
106,89,78,2245340,1482,3178,1057600
107,91,71,2245256,1495,3249,1100300
108,121,75,2245146,1530,3324,1115900
109,90,72,2245046,1558,3396,1149000
110,93,87,2244951,1566,3483,1107800
111,92,93,2244862,1562,3576,1050200
112,102,102,2244758,1564,3678,1036900
113,83,95,2244678,1549,3773,993200
114,77,97,2244597,1533,3870,1186000
115,83,87,2244511,1532,3957,992300
116,92,79,2244423,1541,4036,1029700
117,68,77,2244347,1540,4113,1054500
118,87,83,2244267,1537,4196,1115100
119,95,77,2244170,1557,4273,1237200
120,99,68,2244075,1584,4341,1091200
121,106,84,2243968,1607,4425,1028000
122,80,71,2243886,1618,4496,1018600
123,101,70,2243788,1646,4566,1036200
124,126,78,2243667,1689,4644,1097300
125,93,88,2243572,1696,4732,1218900
126,116,109,2243458,1701,4841,1229200
127,109,82,2243346,1731,4923,1482900
128,124,78,2243224,1775,5001,1378600
129,113,93,2243112,1794,5094,1353800
130,120,110,2242990,1806,5204,1226700
131,115,89,2242875,1832,5293,1241700
132,117,89,2242759,1859,5382,1285700
133,116,96,2242653,1869,5478,1207100
134,115,104,2242521,1897,5582,1128300
135,107,91,2242423,1904,5673,1205200
136,113,91,2242310,1926,5764,1258900
137,101,102,2242203,1931,5866,1305500
138,119,108,2242093,1933,5974,1390700
139,116,87,2241972,1967,6061,1384100
140,115,114,2241860,1965,6175,1292200
141,118,87,2241745,1993,6262,1258300
142,110,104,2241622,2012,6366,1299800
143,124,101,2241502,2031,6467,1244500
144,100,117,2241409,2007,6584,1382700
145,121,101,2241283,2032,6685,1231300
146,103,111,2241181,2023,6796,1254500
147,137,107,2241047,2050,6903,1247900
148,140,99,2240906,2092,7002,1293900
149,109,113,2240792,2093,7115,1210200
150,124,107,2240676,2102,7222,1214100
151,107,113,2240561,2104,7335,1100600
152,144,120,2240423,2122,7455,1059900
153,128,108,2240296,2141,7563,1035200
154,136,108,2240152,2177,7671,995400
155,109,126,2240041,2162,7797,1008900
156,117,103,2239937,2163,7900,996700
157,136,124,2239808,2168,8024,1129000
158,130,107,2239673,2196,8131,1056200
159,153,132,2239518,2219,8263,1066100
160,127,117,2239390,2230,8380,1066800
161,124,123,2239262,2235,8503,1025500
162,144,111,2239123,2263,8614,1033000
163,133,118,2238992,2276,8732,1063400
164,154,106,2238829,2333,8838,1058900
165,161,144,2238681,2337,8982,1054200
166,134,123,2238542,2353,9105,1054100
167,136,110,2238405,2380,9215,1274100
168,150,129,2238250,2406,9344,1112100
169,143,119,2238119,2418,9463,1102200
170,179,150,2237939,2448,9613,1085800
171,140,112,2237794,2481,9725,1145900
172,173,119,2237627,2529,9844,1146600
173,163,147,2237458,2551,9991,1122000
174,161,134,2237298,2577,10125,1215700
175,176,149,2237128,2598,10274,1289700
176,142,144,2236976,2606,10418,1326100
177,176,150,2236807,2625,10568,1208900
178,167,139,2236638,2655,10707,1218600
179,188,149,2236453,2691,10856,1231700
180,143,150,2236305,2689,11006,1172300
181,168,142,2236138,2714,11148,1131400
182,158,159,2235975,2718,11307,1118500
183,151,123,2235826,2744,11430,1085200
184,168,154,2235665,2751,11584,1066800
185,176,146,2235492,2778,11730,1047300
186,147,144,2235336,2790,11874,1145600
187,184,143,2235147,2836,12017,1071600
188,162,151,2234991,2841,12168,1025800
189,168,151,2234836,2845,12319,1053800
190,177,164,2234654,2863,12483,1008600
191,181,125,2234457,2935,12608,1010100
192,178,130,2234288,2974,12738,1079100
193,132,142,2234159,2961,12880,1065800
194,167,149,2233993,2978,13029,1099000
195,198,151,2233791,3029,13180,1048300
196,150,156,2233647,3017,13336,1046100
197,163,152,2233488,3024,13488,1081700
198,189,160,2233294,3058,13648,1139800
199,172,159,2233128,3065,13807,1110400
200,166,183,2232954,3056,13990,1126500
201,172,162,2232781,3067,14152,1164800
202,188,175,2232597,3076,14327,1085100
203,187,157,2232406,3110,14484,1172400
204,204,168,2232210,3138,14652,1067500
205,196,156,2232018,3174,14808,1041500
206,184,162,2231824,3206,14970,1088600
207,179,162,2231649,3219,15132,1086800
208,196,157,2231468,3243,15289,1174800
209,196,168,2231258,3285,15457,1163700
210,212,157,2231052,3334,15614,1107100
211,190,167,2230849,3370,15781,1064400
212,184,164,2230676,3379,15945,1057600
213,187,152,2230486,3417,16097,1071400
214,193,141,2230294,3468,16238,1103000
215,197,170,2230092,3500,16408,1171600
216,189,205,2229912,3475,16613,1189400
217,199,173,2229704,3510,16786,1158200
218,174,175,2229515,3524,16961,1179400
219,214,187,2229326,3526,17148,1091900
220,199,187,2229111,3554,17335,1184000
221,200,192,2228931,3542,17527,1236700
222,178,167,2228744,3562,17694,1131100
223,230,179,2228517,3610,17873,1103100
224,209,170,2228296,3661,18043,1069800
225,231,195,2228077,3685,18238,1198900
226,213,212,2227868,3682,18450,1221200
227,221,191,2227644,3715,18641,1128600
228,226,191,2227415,3753,18832,1139100
229,217,209,2227205,3754,19041,1158100
230,218,188,2226998,3773,19229,1169300
231,263,194,2226724,3853,19423,1146500
232,235,210,2226489,3878,19633,1107700
233,220,197,2226272,3898,19830,1112200
234,244,205,2226025,3940,20035,1121800
235,242,209,2225779,3977,20244,1134500
236,241,237,2225542,3977,20481,1132600
237,224,219,2225311,3989,20700,1089600
238,258,199,2225063,4038,20899,1128700
239,239,207,2224820,4074,21106,1156600
240,222,223,2224593,4078,21329,1110000
241,249,213,2224358,4100,21542,1109100
242,251,233,2224106,4119,21775,1144800
243,225,196,2223865,4164,21971,1041400
244,249,225,2223619,4185,22196,1141600
245,250,205,2223381,4218,22401,1083600
246,242,197,2223130,4272,22598,1060900
247,216,190,2222903,4309,22788,1228300
248,222,230,2222691,4291,23018,1089500
249,248,198,2222458,4326,23216,1285800
250,266,196,2222182,4406,23412,1152800
251,249,209,2221933,4446,23621,1102600
252,258,210,2221679,4490,23831,1096700
253,257,251,2221422,4496,24082,1091300
254,221,217,2221199,4502,24299,1040900
255,260,264,2220947,4490,24563,5094400
256,244,221,2220686,4530,24784,1630200
257,255,246,2220437,4533,25030,1338100
258,231,236,2220200,4534,25266,1354900
259,243,239,2219962,4533,25505,1392600
260,246,214,2219712,4569,25719,1242500
261,230,227,2219489,4565,25946,1198900
262,231,237,2219249,4568,26183,1235000
263,265,284,2218989,4544,26467,1101500
264,224,247,2218766,4520,26714,1088600
265,256,214,2218502,4570,26928,1159700
266,223,225,2218279,4568,27153,1183000
267,253,237,2218054,4556,27390,1248400
268,219,227,2217807,4576,27617,1162300
269,224,214,2217590,4579,27831,1138900
270,220,238,2217364,4567,28069,1101500
271,243,258,2217129,4544,28327,1109500
272,223,225,2216905,4543,28552,1119200
273,243,227,2216652,4569,28779,1129900
274,243,245,2216412,4564,29024,1164700
275,251,239,2216176,4561,29263,1161300
276,247,253,2215941,4543,29516,1260800
277,232,260,2215693,4531,29776,1169500
278,268,227,2215423,4574,30003,1113600
279,271,255,2215151,4591,30258,1084500
280,246,270,2214907,4565,30528,1158900
281,234,234,2214667,4571,30762,1134800
282,246,218,2214433,4587,30980,1138800
283,261,228,2214161,4631,31208,1163500
284,249,239,2213909,4644,31447,1161500
285,221,244,2213686,4623,31691,1188600
286,262,244,2213438,4627,31935,1096600
287,264,270,2213174,4621,32205,1110300
288,281,253,2212894,4648,32458,1141400
289,239,237,2212651,4654,32695,1143500
290,259,230,2212396,4679,32925,1114200
291,232,270,2212153,4652,33195,1104900
292,272,224,2211889,4692,33419,1071000
293,289,247,2211600,4734,33666,1046400
294,286,263,2211314,4757,33929,1026700
295,282,240,2211049,4782,34169,1037700
296,255,222,2210781,4828,34391,1075500
297,252,263,2210528,4818,34654,1083400
298,271,262,2210252,4832,34916,1051200
299,244,254,2210006,4824,35170,1142500
300,264,255,2209741,4834,35425,1064900
301,273,253,2209473,4849,35678,1123600
302,329,269,2209163,4890,35947,1195000
303,298,243,2208841,4969,36190,1158700
304,286,290,2208570,4950,36480,1146400
305,287,268,2208271,4981,36748,1113000
306,304,248,2207976,5028,36996,1431200
307,304,243,2207671,5090,37239,1276400
308,291,267,2207387,5107,37506,1300000
309,311,287,2207078,5129,37793,1276200
310,288,262,2206786,5159,38055,1286000
311,305,283,2206470,5192,38338,1270600
312,290,258,2206184,5220,38596,1252600
313,301,303,2205897,5204,38899,1171900
314,314,258,2205590,5253,39157,1153700
315,321,275,2205244,5324,39432,1145800
316,290,255,2204970,5343,39687,1137800
317,297,292,2204670,5351,39979,1081500
318,310,312,2204350,5359,40291,1080000
319,316,281,2204053,5375,40572,1092400
320,286,264,2203753,5411,40836,1094800
321,278,296,2203474,5394,41132,1125400
322,272,293,2203189,5386,41425,1064300
323,324,289,2202891,5395,41714,1122600
324,306,274,2202578,5434,41988,1169600
325,278,263,2202295,5454,42251,1110900
326,287,279,2202014,5456,42530,1149800
327,303,291,2201706,5473,42821,1165000
328,279,303,2201425,5451,43124,1168500
329,289,307,2201133,5436,43431,1193000
330,295,303,2200844,5422,43734,1199800
331,295,268,2200550,5448,44002,1245700
332,308,299,2200244,5455,44301,1480100
333,301,292,2199937,5470,44593,1311200
334,315,283,2199631,5493,44876,1424100
335,333,299,2199296,5529,45175,1428000
336,313,275,2198984,5566,45450,1363400
337,303,264,2198662,5624,45714,1325000
338,329,293,2198349,5644,46007,1395900
339,333,313,2198034,5646,46320,1275600
340,347,293,2197689,5698,46613,1300000
341,349,292,2197336,5759,46905,1424700
342,335,271,2196999,5825,47176,1269900
343,309,322,2196691,5811,47498,1239600
344,364,297,2196321,5884,47795,1342500
345,343,332,2195970,5903,48127,1218500
346,337,306,2195637,5930,48433,1169700
347,318,352,2195316,5899,48785,1236800
348,316,323,2195011,5881,49108,1089800
349,330,294,2194675,5923,49402,1140100
350,336,310,2194344,5944,49712,1109800
351,340,336,2193993,5959,50048,1172400
352,333,313,2193669,5970,50361,1152700
353,353,336,2193326,5977,50697,1082600
354,326,326,2192969,6008,51023,1147400
355,319,331,2192668,5978,51354,1139900
356,336,318,2192347,5981,51672,1187500
357,331,324,2191986,6018,51996,1119000
358,330,341,2191685,5978,52337,1174000
359,357,333,2191304,6026,52670,1223000
360,361,332,2190963,6035,53002,1247900
361,331,329,2190626,6043,53331,1157800
362,358,307,2190272,6090,53638,1220100
363,343,303,2189920,6139,53941,1222100
364,351,300,2189577,6182,54241,1263900
365,384,361,2189201,6197,54602,1244900
366,371,298,2188823,6277,54900,1218400
367,333,314,2188479,6307,55214,1270200
368,333,317,2188133,6336,55531,1204700
369,361,309,2187787,6373,55840,1234600
370,338,309,2187460,6391,56149,1343600
371,368,334,2187092,6425,56483,1238900
372,347,316,2186739,6462,56799,1230500
373,357,351,2186406,6444,57150,1207000
374,369,353,2186017,6480,57503,1216900
375,381,349,2185644,6504,57852,1246100
376,380,352,2185262,6534,58204,1443700
377,354,333,2184902,6561,58537,1315300
378,391,353,2184527,6583,58890,1280400
379,371,343,2184143,6624,59233,1358100
380,385,323,2183750,6694,59556,1253900
381,354,346,2183381,6717,59902,1410700
382,373,329,2183048,6721,60231,1404900
383,374,365,2182657,6747,60596,1337800
384,370,324,2182290,6790,60920,1556700
385,369,339,2181909,6832,61259,1496700
386,407,352,2181518,6871,61611,1527200
387,373,371,2181141,6877,61982,1582300
388,377,334,2180766,6918,62316,1401200
389,416,364,2180339,6981,62680,1296100
390,399,353,2179967,7000,63033,1293200
391,375,412,2179570,6985,63445,1335600
392,436,379,2179158,7018,63824,1306700
393,419,337,2178721,7118,64161,1308900
394,398,385,2178317,7137,64546,1263500
395,390,381,2177926,7147,64927,1429300
396,421,354,2177521,7198,65281,1286900
397,393,367,2177119,7233,65648,1247500
398,388,372,2176729,7251,66020,1318000
399,434,361,2176309,7310,66381,1420200
400,386,409,2175923,7287,66790,1286900
401,408,396,2175508,7306,67186,1297800
402,380,391,2175133,7290,67577,1277200
403,404,364,2174706,7353,67941,1292800
404,382,394,2174336,7329,68335,1247800
405,441,375,2173890,7400,68710,1246700
406,420,404,2173477,7409,69114,1136700
407,419,398,2173069,7419,69512,1211500
408,425,408,2172635,7445,69920,1190900
409,414,377,2172236,7467,70297,1113700
410,419,400,2171800,7503,70697,1170500
411,386,401,2171409,7493,71098,1211500
412,429,411,2171007,7484,71509,1121300
413,459,368,2170550,7573,71877,1112400
414,459,393,2170078,7652,72270,1189700
415,431,433,2169629,7668,72703,1140300
416,372,407,2169256,7634,73110,1101900
417,404,410,2168863,7617,73520,1114800
418,417,388,2168449,7643,73908,1147500
419,447,386,2168002,7704,74294,1143100
420,423,426,2167573,7707,74720,1149400
421,441,399,2167139,7742,75119,1104100
422,401,397,2166720,7764,75516,1212500
423,446,400,2166282,7802,75916,1144800
424,447,441,2165848,7795,76357,1157100
425,419,370,2165433,7840,76727,1392900
426,398,432,2165025,7816,77159,1349200
427,436,422,2164593,7826,77581,1152900
428,422,378,2164177,7864,77959,1135900
429,402,431,2163756,7854,78390,1282400
430,432,416,2163352,7842,78806,1250500
431,374,410,2162949,7835,79216,1310600
432,384,425,2162559,7800,79641,1216700
433,383,411,2162190,7758,80052,1193900
434,406,425,2161793,7730,80477,1190900
435,442,441,2161350,7732,80918,1209000
436,382,410,2160957,7715,81328,1186700
437,402,398,2160554,7720,81726,1169200
438,416,356,2160130,7788,82082,1180900
439,439,368,2159714,7836,82450,1211500
440,407,438,2159296,7816,82888,1188200
441,455,418,2158846,7848,83306,1230700
442,423,426,2158420,7848,83732,1269400
443,405,390,2158005,7873,84122,1210600
444,423,408,2157594,7876,84530,1188900
445,418,407,2157173,7890,84937,1180700
446,467,418,2156717,7928,85355,1135400
447,417,408,2156279,7958,85763,1191000
448,464,394,2155816,8027,86157,1214900
449,487,447,2155337,8059,86604,1231500
450,452,431,2154887,8078,87035,1254300
451,426,427,2154458,8080,87462,1133300
452,452,413,2154008,8117,87875,1170500
453,463,449,2153547,8129,88324,1181900
454,469,391,2153091,8194,88715,1188200
455,507,435,2152596,8254,89150,1176700
456,464,417,2152104,8329,89567,1283500
457,453,401,2151665,8367,89968,1169900
458,431,435,2151215,8382,90403,1182300
459,445,433,2150796,8368,90836,1177100
460,427,427,2150331,8406,91263,1250000
461,482,432,2149890,8415,91695,1393000
462,463,432,2149423,8450,92127,1230000
463,481,442,2148937,8494,92569,1234900
464,471,438,2148462,8531,93007,1422000
465,429,445,2148027,8521,93452,1280700
466,410,431,2147615,8502,93883,1290300
467,405,433,2147208,8476,94316,1459400
468,466,393,2146750,8541,94709,1442600
469,513,438,2146259,8594,95147,1405600
470,487,433,2145762,8658,95580,1306700
471,488,432,2145267,8721,96012,1396100
472,464,460,2144799,8729,96472,1279600
473,506,485,2144321,8722,96957,1294800
474,451,456,2143841,8746,97413,1247800
475,500,446,2143352,8789,97859,1199300
476,476,439,2142864,8838,98298,1136400
477,504,454,2142383,8865,98752,1177100
478,546,460,2141844,8944,99212,1296100
479,489,498,2141325,8965,99710,1310600
480,479,455,2140864,8971,100165,1206000
481,498,495,2140368,8972,100660,1193300
482,527,507,2139837,8996,101167,1248100
483,467,495,2139372,8966,101662,1178600
484,516,459,2138849,9030,102121,1139300
485,480,517,2138356,9006,102638,1154400
486,500,470,2137876,9016,103108,1162200
487,488,456,2137380,9056,103564,1176800
488,504,467,2136875,9094,104031,1179300
489,494,458,2136381,9130,104489,1260500
490,495,496,2135893,9122,104985,1202500
491,498,470,2135398,9147,105455,1210400
492,541,482,2134852,9211,105937,1583800
493,472,525,2134382,9156,106462,1267100
494,509,465,2133872,9201,106927,1255400
495,511,462,2133349,9262,107389,1295700
496,503,499,2132843,9269,107888,1431000
497,486,469,2132373,9270,108357,1356600
498,485,499,2131890,9254,108856,1327800
499,502,498,2131384,9262,109354,1452600
500,489,478,2130894,9274,109832,1384400
501,477,432,2130404,9332,110264,1690500
502,464,479,2129960,9297,110743,1507800
503,480,461,2129469,9327,111204,1238300
504,510,519,2128955,9322,111723,1504000
505,492,520,2128443,9314,112243,1272700
506,495,505,2127974,9278,112748,1238000
507,502,488,2127480,9284,113236,1341700
508,509,450,2126975,9339,113686,1236600
509,438,427,2126509,9378,114113,1150200
510,531,489,2126010,9388,114602,1320000
511,501,437,2125483,9478,115039,1182900
512,524,469,2124963,9529,115508,1108400
513,487,528,2124486,9478,116036,1155100
514,489,523,2123982,9459,116559,1082800
515,507,464,2123480,9497,117023,1103400
516,505,438,2122979,9560,117461,1136800
517,456,486,2122521,9532,117947,1103300
518,499,524,2122036,9493,118471,1120200
519,501,510,2121521,9498,118981,1110600
520,476,478,2121039,9502,119459,1131600
521,500,501,2120559,9481,119960,1066100
522,549,495,2120018,9527,120455,1141500
523,562,487,2119449,9609,120942,1083100
524,522,468,2118925,9665,121410,1198000
525,499,516,2118416,9658,121926,1143700
526,525,505,2117879,9690,122431,1129000
527,514,512,2117377,9680,122943,1198700
528,526,468,2116864,9725,123411,1165900
529,542,505,2116315,9769,123916,1086500
530,524,529,2115795,9760,124445,1128500
531,537,524,2115261,9770,124969,1116600
532,591,509,2114671,9851,125478,1113600
533,543,484,2114120,9918,125962,1175500
534,553,554,2113577,9907,126516,1129900
535,549,530,2113017,9937,127046,1121000
536,548,528,2112471,9955,127574,1084800
537,554,513,2111913,10000,128087,1107300
538,517,498,2111408,10007,128585,1160700
539,568,516,2110827,10072,129101,1161700
540,571,501,2110254,10144,129602,1106300
541,574,499,2109703,10196,130101,1079100
542,596,505,2109136,10258,130606,1088200
543,571,555,2108517,10322,131161,1098800
544,561,545,2107962,10332,131706,1125500
545,588,523,2107384,10387,132229,1139500
546,515,528,2106851,10392,132757,1145800
547,536,522,2106320,10401,133279,1225200
548,596,515,2105738,10468,133794,1280500
549,644,571,2105110,10525,134365,1247200
550,561,549,2104527,10559,134914,1222900
551,553,561,2103982,10543,135475,1260500
552,515,534,2103433,10558,136009,1423900
553,533,537,2102919,10535,136546,1423900
554,574,551,2102351,10552,137097,1218900
555,560,540,2101784,10579,137637,1291500
556,593,517,2101214,10632,138154,1231500
557,605,536,2100612,10698,138690,1274700
558,564,558,2100030,10722,139248,1400500
559,599,538,2099431,10783,139786,1681700
560,575,570,2098856,10788,140356,1682700
561,623,522,2098249,10873,140878,1920300
562,605,583,2097625,10914,141461,1614500
563,579,618,2097046,10875,142079,1774500
564,590,568,2096468,10885,142647,2003600
565,569,500,2095888,10965,143147,1529000
566,609,553,2095305,10995,143700,1565600
567,573,582,2094712,11006,144282,1697100
568,594,536,2094127,11055,144818,1705700
569,576,560,2093534,11088,145378,1380700
570,592,591,2092955,11076,145969,1487600
571,531,595,2092400,11036,146564,1379700
572,612,580,2091805,11051,147144,1413100
573,542,518,2091248,11090,147662,1421200
574,539,633,2090719,10986,148295,1454700
575,580,538,2090135,11032,148833,1372300
576,573,577,2089570,11020,149410,1384200
577,576,564,2089008,11018,149974,1385300
578,598,568,2088388,11070,150542,1370000
579,567,567,2087837,11054,151109,1310500
580,595,584,2087251,11056,151693,1317100
581,560,590,2086672,11045,152283,1215900
582,573,616,2086098,11003,152899,1312100
583,626,562,2085502,11037,153461,1224800
584,586,598,2084865,11076,154059,1200500
585,597,590,2084277,11074,154649,1194900
586,572,598,2083726,11027,155247,1164500
587,603,552,2083102,11099,155799,1288400
588,570,575,2082535,11091,156374,1208100
589,594,577,2081935,11114,156951,1261100
590,552,622,2081405,11022,157573,1307400
591,594,596,2080815,11016,158169,1269600
592,571,568,2080234,11029,158737,1270000
593,592,564,2079638,11061,159301,1307500
594,603,624,2079042,11033,159925,1597100
595,569,588,2078470,11017,160513,1324500
596,611,578,2077886,11023,161091,1470200
597,598,650,2077264,10995,161741,1669300
598,557,560,2076672,11027,162301,1378700
599,577,551,2076122,11026,162852,1409700
600,569,567,2075552,11029,163419,1503800
601,570,553,2075003,11025,163972,1409400
602,519,616,2074458,10954,164588,1380700
603,585,582,2073877,10953,165170,1352600
604,554,540,2073329,10961,165710,1252900
605,601,592,2072742,10956,166302,1213400
606,584,563,2072140,10995,166865,1347000
607,576,535,2071563,11037,167400,1255400
608,563,583,2071004,11013,167983,1262400
609,599,603,2070431,10983,168586,1269500
610,598,558,2069798,11058,169144,1217800
611,586,592,2069230,11034,169736,1216600
612,591,580,2068629,11055,170316,1255600
613,571,601,2068076,11007,170917,1198800
614,607,530,2067471,11082,171447,1218700
615,597,532,2066856,11165,171979,1291900
616,614,568,2066261,11192,172547,1217600
617,605,602,2065637,11214,173149,1220800
618,593,579,2065046,11226,173728,1180200
619,600,581,2064446,11245,174309,1221100
620,571,587,2063850,11254,174896,1187100
621,570,585,2063299,11220,175481,1218800
622,587,607,2062722,11190,176088,1272200
623,616,611,2062117,11184,176699,1187500
624,640,551,2061488,11262,177250,1195800
625,589,586,2060873,11291,177836,1201800
626,608,557,2060264,11343,178393,1251500
627,618,583,2059651,11373,178976,1236400
628,559,539,2059079,11406,179515,1248000
629,634,585,2058463,11437,180100,1260700
630,537,625,2057891,11384,180725,1222900
631,576,577,2057337,11361,181302,1314100
632,558,604,2056788,11306,181906,1392300
633,560,549,2056234,11311,182455,1226700
634,650,601,2055581,11363,183056,1266100
635,581,612,2054994,11338,183668,1267200
636,614,579,2054387,11366,184247,1291800
637,627,556,2053766,11431,184803,1253100
638,615,598,2053129,11470,185401,1187700
639,636,587,2052525,11487,185988,1193300
640,590,608,2051908,11496,186596,1220500
641,583,545,2051334,11525,187141,1237700
642,599,585,2050734,11540,187726,1272700
643,597,596,2050135,11543,188322,1278600
644,618,594,2049529,11555,188916,1348800
645,632,583,2048901,11600,189499,1238400
646,621,616,2048273,11612,190115,1237400
647,584,589,2047663,11633,190704,1420100
648,598,616,2047076,11604,191320,1256300
649,605,609,2046473,11598,191929,1220500
650,664,626,2045815,11630,192555,1165100
651,616,591,2045196,11658,193146,1193800
652,632,630,2044562,11662,193776,1308000
653,623,641,2043966,11617,194417,1205800
654,619,616,2043338,11629,195033,1318300
655,590,606,2042738,11623,195639,1184200
656,654,600,2042085,11676,196239,1306300
657,648,564,2041452,11745,196803,1321500
658,607,614,2040841,11742,197417,1269900
659,641,613,2040209,11761,198030,1294100
660,626,597,2039552,11821,198627,1265000
661,650,623,2038925,11825,199250,1236300
662,647,591,2038293,11866,199841,1288000
663,666,641,2037608,11910,200482,1329600
664,588,598,2037017,11903,201080,1312100
665,583,592,2036416,11912,201672,1287700
666,658,629,2035794,11905,202301,1646800
667,620,595,2035143,11961,202896,1402100
668,664,637,2034499,11968,203533,1181600
669,613,676,2033863,11928,204209,1326700
670,660,654,2033206,11931,204863,1222100
671,625,632,2032607,11898,205495,1427700
672,652,631,2031936,11938,206126,1552500
673,647,608,2031296,11970,206734,1360400
674,636,620,2030644,12002,207354,1264300
675,656,628,2030012,12006,207982,1380200
676,640,603,2029358,12057,208585,1341400
677,664,659,2028712,12044,209244,1252600
678,658,601,2028048,12107,209845,1280200
679,632,629,2027416,12110,210474,1229100
680,655,625,2026759,12142,211099,1300400
681,673,645,2026097,12159,211744,1349200
682,658,664,2025424,12168,212408,1300000
683,651,619,2024786,12187,213027,1211800
684,661,649,2024126,12198,213676,1281700
685,635,679,2023469,12176,214355,1399700
686,676,602,2022804,12239,214957,1218000
687,645,616,2022154,12273,215573,1349200
688,660,651,2021503,12273,216224,1361200
689,694,660,2020817,12299,216884,1334000
690,625,616,2020192,12308,217500,1340900
691,655,613,2019517,12370,218113,1287400
692,682,599,2018843,12445,218712,1283300
693,658,678,2018190,12420,219390,1362800
694,675,602,2017539,12469,219992,1351800
695,677,657,2016853,12498,220649,1394100
696,666,590,2016171,12590,221239,1274000
697,695,688,2015488,12585,221927,1371000
698,644,667,2014819,12587,222594,1298100
699,644,658,2014210,12538,223252,1323600
700,623,655,2013543,12550,223907,1354700
701,690,694,2012866,12533,224601,1363500
702,680,668,2012192,12539,225269,1397200
703,634,658,2011547,12526,225927,1322600
704,655,681,2010896,12496,226608,1318700
705,675,673,2010233,12486,227281,1240900
706,600,607,2009611,12501,227888,1234900
707,614,627,2009002,12483,228515,1423700
708,659,654,2008367,12464,229169,1360400
709,651,637,2007724,12470,229806,1369100
710,730,639,2006989,12566,230445,1399600
711,665,643,2006301,12611,231088,1345500
712,655,714,2005654,12544,231802,1210900
713,597,637,2005048,12513,232439,1317600
714,633,648,2004415,12498,233087,1372000
715,699,646,2003729,12538,233733,1305800
716,639,665,2003108,12494,234398,1417900
717,699,663,2002395,12544,235061,2238500
718,695,656,2001704,12579,235717,1771100
719,669,687,2001042,12554,236404,1495500
720,677,654,2000359,12583,237058,1493300
721,682,658,1999671,12613,237716,1383200
722,680,671,1998964,12649,238387,1331100
723,687,674,1998300,12639,239061,1407300
724,672,701,1997611,12627,239762,1496000
725,666,666,1996943,12629,240428,1552500
726,687,712,1996272,12588,241140,1319000
727,650,647,1995623,12590,241787,1279500
728,639,644,1994982,12587,242431,1389800
729,723,675,1994270,12624,243106,1269400
730,731,669,1993534,12691,243775,1373200
731,690,659,1992871,12695,244434,1431900
732,704,657,1992152,12757,245091,1335100
733,693,634,1991458,12817,245725,1248700
734,698,666,1990740,12869,246391,1312200
735,671,658,1990070,12881,247049,1211100
736,647,679,1989426,12846,247728,1193000
737,681,676,1988753,12843,248404,1132100
738,700,599,1988044,12953,249003,1193500
739,700,689,1987359,12949,249692,1230800
740,705,682,1986652,12974,250374,1180400
741,700,669,1985957,13000,251043,1216100
742,676,710,1985271,12976,251753,1225300
743,787,679,1984483,13085,252432,1201100
744,699,682,1983771,13115,253114,1237400
745,698,672,1983077,13137,253786,1255800
746,687,727,1982386,13101,254513,1301000
747,688,700,1981697,13090,255213,1252000
748,686,680,1981008,13099,255893,1713100
749,684,665,1980333,13109,256558,1396900
750,673,635,1979673,13134,257193,1269700
751,679,702,1978989,13116,257895,1297200
752,688,663,1978293,13149,258558,1150300
753,697,675,1977614,13153,259233,1180700
754,679,658,1976917,13192,259891,1157900
755,672,684,1976264,13161,260575,1308500
756,669,672,1975613,13140,261247,1235900
757,709,719,1974867,13167,261966,1179500
758,650,715,1974185,13134,262681,1263900
759,721,715,1973493,13111,263396,1254500
760,729,672,1972806,13126,264068,1352500
761,674,714,1972097,13121,264782,1290500
762,716,678,1971395,13145,265460,1192800
763,665,654,1970705,13181,266114,1260100
764,653,717,1970063,13106,266831,1152700
765,683,647,1969386,13136,267478,1291600
766,661,655,1968694,13173,268133,1427500
767,704,625,1968048,13194,268758,1524800
768,700,673,1967321,13248,269431,1804300
769,695,687,1966615,13267,270118,1399300
770,656,714,1965975,13193,270832,1360800
771,707,716,1965284,13168,271548,1351300
772,674,699,1964581,13172,272247,1341400
773,658,648,1963918,13187,272895,1246000
774,675,678,1963238,13189,273573,1374300
775,662,658,1962576,13193,274231,1237200
776,628,750,1961940,13079,274981,1242900
777,721,660,1961246,13113,275641,1300800
778,697,701,1960548,13110,276342,1470300
779,676,682,1959873,13103,277024,1414700
780,721,715,1959144,13117,277739,1332000
781,636,657,1958500,13104,278396,1292600
782,731,683,1957810,13111,279079,1214700
783,688,639,1957096,13186,279718,1296400
784,679,704,1956406,13172,280422,1239600
785,676,684,1955740,13154,281106,1350400
786,677,674,1955067,13153,281780,1344600
787,732,706,1954335,13179,282486,1264100
788,636,661,1953686,13167,283147,1263200
789,719,676,1952977,13200,283823,1123700
790,672,710,1952317,13150,284533,1120600
791,690,654,1951598,13215,285187,1167100
792,681,673,1950950,13190,285860,1203700
793,756,673,1950189,13278,286533,1133200
794,726,704,1949446,13317,287237,1095700
795,679,676,1948757,13330,287913,1202800
796,705,674,1948070,13343,288587,1141700
797,766,716,1947310,13387,289303,1229000
798,711,707,1946594,13396,290010,1362400
799,720,717,1945879,13394,290727,1292300
800,661,698,1945211,13364,291425,1275100
801,743,725,1944465,13385,292150,1282600
802,649,676,1943793,13381,292826,1208600
803,690,664,1943115,13395,293490,1144900
804,651,695,1942463,13352,294185,1170200
805,714,652,1941773,13390,294837,1228600
806,746,662,1941027,13474,295499,1228200
807,744,685,1940273,13543,296184,1276200
808,708,686,1939573,13557,296870,1271700
809,718,776,1938851,13503,297646,1183800
810,715,669,1938141,13544,298315,1154200
811,731,710,1937408,13567,299025,1193000
812,690,686,1936727,13562,299711,1166900
813,701,685,1936010,13594,300396,1248600
814,707,715,1935288,13601,301111,1175100
815,751,708,1934571,13610,301819,1126700
816,694,703,1933860,13618,302522,1153700
817,704,699,1933158,13621,303221,1142900
818,689,749,1932458,13572,303970,1147100
819,703,735,1931757,13538,304705,1199100
820,764,717,1930998,13580,305422,1193700
821,716,702,1930284,13592,306124,1252100
822,711,720,1929560,13596,306844,1215600
823,721,756,1928844,13556,307600,1196900
824,716,711,1928140,13549,308311,1118200
825,676,636,1927447,13606,308947,1116800
826,710,700,1926750,13603,309647,1117300
827,709,734,1926046,13573,310381,1226900
828,706,724,1925322,13573,311105,1191300
829,696,724,1924664,13507,311829,1278900
830,690,699,1923957,13515,312528,1269500
831,769,725,1923198,13549,313253,1161100
832,713,732,1922473,13542,313985,1247100
833,733,714,1921731,13570,314699,1196200
834,744,723,1920997,13581,315422,1224000
835,721,707,1920262,13609,316129,1175000
836,725,697,1919564,13610,316826,1193400
837,662,679,1918869,13626,317505,1136800
838,780,706,1918123,13666,318211,1164100
839,766,719,1917335,13735,318930,1232600
840,766,717,1916566,13787,319647,1210100
841,720,687,1915858,13808,320334,1196300
842,732,717,1915116,13833,321051,1161200
843,742,750,1914384,13815,321801,1191800
844,745,732,1913643,13824,322533,1155900
845,815,773,1912847,13847,323306,1241700
846,766,650,1912067,13977,323956,1188400
847,814,720,1911266,14058,324676,1247200
848,767,761,1910497,14066,325437,1290300
849,777,702,1909696,14165,326139,1207800
850,739,726,1908979,14156,326865,1357300
851,734,723,1908231,14181,327588,1318900
852,764,756,1907478,14178,328344,1273700
853,757,718,1906710,14228,329062,1181600
854,749,745,1905971,14222,329807,1178100
855,760,730,1905199,14264,330537,1198900
856,824,770,1904400,14293,331307,1175200
857,791,763,1903608,14322,332070,1151700
858,831,737,1902754,14439,332807,1162200
859,752,766,1901987,14440,333573,1157400
860,796,756,1901205,14466,334329,1184100
861,779,769,1900428,14474,335098,1123700
862,749,755,1899676,14471,335853,1153900
863,739,728,1898941,14478,336581,1227000
864,765,779,1898175,14465,337360,1264100
865,734,783,1897426,14431,338143,1168700
866,763,760,1896678,14419,338903,1173100
867,721,785,1895951,14361,339688,1178800
868,732,757,1895216,14339,340445,1173900
869,749,745,1894468,14342,341190,1199300
870,748,720,1893731,14359,341910,1331100
871,714,754,1892982,14354,342664,1201300
872,766,767,1892263,14306,343431,1277000
873,726,719,1891526,14324,344150,1254000
874,763,774,1890758,14318,344924,1397300
875,766,740,1889998,14338,345664,1189500
876,743,739,1889255,14342,346403,1167600
877,752,740,1888509,14348,347143,1159800
878,806,739,1887689,14429,347882,1254400
879,773,746,1886890,14482,348628,1211100
880,722,771,1886176,14425,349399,1230800
881,749,707,1885433,14461,350106,1178400
882,781,723,1884680,14491,350829,1244500
883,781,832,1883877,14462,351661,1153900
884,780,720,1883118,14501,352381,1121000
885,743,720,1882367,14532,353101,1161500
886,754,753,1881617,14529,353854,1218900
887,770,759,1880849,14538,354613,1150000
888,802,744,1880040,14603,355357,1225400
889,817,755,1879232,14656,356112,1132800
890,803,757,1878440,14691,356869,1133000
891,734,750,1877677,14704,357619,1221500
892,807,769,1876871,14741,358388,1198400
893,805,788,1876087,14737,359176,1276300
894,730,775,1875341,14708,359951,1268100
895,766,775,1874549,14725,360726,1408600
896,791,802,1873787,14685,361528,1662100
897,789,768,1873000,14704,362296,1354400
898,738,711,1872246,14747,363007,1306200
899,818,754,1871450,14789,363761,1325400
900,741,794,1870688,14757,364555,1365000
901,753,751,1869938,14756,365306,1372600
902,815,770,1869160,14764,366076,1274800
903,773,764,1868363,14797,366840,1193200
904,815,745,1867584,14831,367585,1284600
905,784,752,1866769,14894,368337,1271200
906,776,816,1865989,14858,369153,1213200
907,783,831,1865194,14822,369984,1319300
908,830,750,1864382,14884,370734,1181000
909,819,801,1863568,14897,371535,1269700
910,781,775,1862771,14919,372310,1210800
911,801,735,1861958,14997,373045,1252300
912,854,804,1861120,15031,373849,1217100
913,810,811,1860302,15038,374660,1237000
914,804,741,1859502,15097,375401,1232100
915,876,771,1858637,15191,376172,1248200
916,875,778,1857764,15286,376950,1309400
917,859,849,1856913,15288,377799,1286400
918,861,769,1856074,15358,378568,1259300
919,858,816,1855182,15434,379384,1230400
920,820,825,1854381,15410,380209,1290600
921,920,814,1853466,15511,381023,1231900
922,863,812,1852590,15575,381835,1375500
923,868,813,1851720,15632,382648,1405600
924,906,819,1850848,15685,383467,1831900
925,902,800,1849908,15825,384267,1365300
926,859,868,1849060,15805,385135,1542900
927,875,807,1848193,15865,385942,1557500
928,875,874,1847317,15867,386816,1915900
929,824,779,1846486,15919,387595,1688800
930,891,828,1845580,15997,388423,1404900
931,896,819,1844716,16042,389242,1307000
932,823,815,1843873,16070,390057,1226000
933,872,833,1843002,16108,390890,1442000
934,854,819,1842136,16155,391709,1403100
935,873,857,1841276,16158,392566,1238000
936,847,830,1840423,16181,393396,1592000
937,885,826,1839552,16226,394222,1509400
938,859,869,1838682,16227,395091,1280800
939,917,819,1837781,16309,395910,1326900
940,922,862,1836862,16366,396772,1375400
941,833,843,1836005,16380,397615,1317700
942,828,860,1835161,16364,398475,1290300
943,792,868,1834368,16289,399343,1356400
944,845,801,1833543,16313,400144,1181900
945,813,826,1832746,16284,400970,1131700
946,821,839,1831888,16303,401809,1291500
947,853,820,1831064,16307,402629,1256900
948,836,874,1830208,16289,403503,1218400
949,857,866,1829350,16281,404369,1292500
950,846,843,1828523,16265,405212,1265300
951,834,867,1827681,16240,406079,1326700
952,920,863,1826782,16276,406942,1332200
953,869,833,1825880,16345,407775,1275800
954,832,771,1825089,16365,408546,1288200
955,909,837,1824173,16444,409383,1397800
956,846,874,1823282,16461,410257,1156500
957,914,871,1822415,16457,411128,1199500
958,865,821,1821548,16503,411949,1309500
959,855,853,1820644,16554,412802,1304800
960,907,861,1819794,16543,413663,1340600
961,863,838,1818917,16582,414501,1717700
962,883,866,1818044,16589,415367,1549300
963,870,885,1817159,16589,416252,1535900
964,886,841,1816287,16620,417093,1397500
965,890,868,1815372,16667,417961,1485000
966,905,909,1814483,16647,418870,1632400
967,875,822,1813589,16719,419692,1354500
968,872,879,1812721,16708,420571,1411400
969,902,914,1811830,16685,421485,1693300
970,890,888,1810932,16695,422373,1271200
971,933,863,1810026,16738,423236,1326200
972,884,894,1809142,16728,424130,1472400
973,869,806,1808228,16836,424936,1350200
974,921,773,1807316,16975,425709,1263400
975,878,898,1806428,16965,426607,1342000
976,920,934,1805534,16925,427541,1348100
977,812,906,1804732,16821,428447,1378900
978,928,881,1803811,16861,429328,1374300
979,858,951,1802929,16792,430279,1699400
980,925,882,1802043,16796,431161,1440700
981,874,932,1801143,16764,432093,1315500
982,899,817,1800239,16851,432910,1341600
983,891,922,1799347,16821,433832,1408600
984,898,882,1798444,16842,434714,1395400
985,891,853,1797560,16873,435567,1235800
986,868,875,1796673,16885,436442,1361400
987,868,846,1795814,16898,437288,1514100
988,892,858,1794931,16923,438146,1382900
989,872,814,1794044,16996,438960,1347800
990,864,861,1793175,17004,439821,1444200
991,886,850,1792319,17010,440671,1245900
992,884,910,1791414,17005,441581,1294400
993,919,895,1790501,17023,442476,1290600
994,890,862,1789616,17046,443338,1337400
995,907,897,1788707,17058,444235,1279300
996,871,907,1787838,17020,445142,1393600
997,931,866,1786886,17106,446008,1319100
998,854,880,1786035,17077,446888,1308600
999,896,896,1785169,17047,447784,1263400
1000,860,869,1784278,17069,448653,1352600
1001,855,892,1783417,17038,449545,1294400
1002,868,878,1782565,17012,450423,1443500
1003,859,862,1781724,16991,451285,1326300
1004,876,884,1780839,16992,452169,1413600
1005,878,907,1779940,16984,453076,1533200
1006,883,910,1779066,16948,453986,1392600
1007,870,898,1778190,16926,454884,1316300
1008,861,883,1777333,16900,455767,1279000
1009,869,841,1776485,16907,456608,1299800
1010,882,892,1775605,16895,457500,1361200
1011,829,855,1774726,16919,458355,1352500
1012,892,878,1773864,16903,459233,1548700
1013,807,816,1773031,16920,460049,1411800
1014,882,897,1772206,16848,460946,1266400
1015,932,879,1771261,16914,461825,1259300
1016,860,870,1770403,16902,462695,1347000
1017,873,892,1769500,16913,463587,1364900
1018,834,869,1768673,16871,464456,1279800
1019,917,846,1767765,16933,465302,1423400
1020,880,859,1766909,16930,466161,1332400
1021,892,891,1766004,16944,467052,1388600
1022,871,875,1765126,16947,467927,1489500
1023,973,844,1764178,17051,468771,1354400
1024,925,870,1763235,17124,469641,1354500
1025,900,891,1762331,17137,470532,1586200
1026,919,952,1761410,17106,471484,1608000
1027,990,878,1760421,17217,472362,1446900
1028,848,944,1759577,17117,473306,1318300
1029,884,900,1758689,17105,474206,1279500
1030,857,891,1757811,17092,475097,1420900
1031,928,923,1756927,17053,476020,1361100
1032,876,884,1756022,17074,476904,1326300
1033,900,871,1755119,17106,477775,1430700
1034,923,885,1754215,17125,478660,1305500
1035,927,917,1753281,17142,479577,1304100
1036,820,857,1752453,17113,480434,1308900
1037,820,861,1751618,17087,481295,1471400
1038,819,914,1750790,17001,482209,1391200
1039,909,852,1749949,16990,483061,1380000
1040,885,893,1749009,17037,483954,1431000
1041,876,903,1748143,17000,484857,1309800
1042,832,895,1747300,16948,485752,1268900
1043,870,870,1746427,16951,486622,1215700
1044,863,861,1745584,16933,487483,1392400
1045,895,870,1744668,16979,488353,1469600
1046,863,881,1743824,16942,489234,1326300
1047,835,845,1742993,16928,490079,1594000
1048,884,899,1742095,16927,490978,1500100
1049,822,857,1741256,16909,491835,1391300
1050,853,882,1740405,16878,492717,1263500
1051,917,949,1739515,16819,493666,1346500
1052,826,852,1738652,16830,494518,1357600
1053,850,893,1737840,16749,495411,1281000
1054,844,838,1736987,16764,496249,1517600
1055,851,915,1736139,16697,497164,1403700
1056,846,847,1735287,16702,498011,1251000
1057,919,888,1734384,16717,498899,1465300
1058,881,851,1733510,16740,499750,1386900
1059,888,885,1732630,16735,500635,1293100
1060,808,861,1731769,16735,501496,1267300
1061,855,863,1730936,16705,502359,1297200
1062,884,964,1730063,16614,503323,1337700
1063,891,872,1729165,16640,504195,1253400
1064,858,837,1728309,16659,505032,1380500
1065,867,840,1727429,16699,505872,1470100
1066,826,846,1726626,16656,506718,1305700
1067,840,809,1725773,16700,507527,1325000
1068,868,862,1724900,16711,508389,1289900
1069,867,855,1724041,16715,509244,1467600
1070,843,865,1723209,16682,510109,1347900
1071,880,935,1722320,16636,511044,1431500
1072,835,898,1721462,16596,511942,1293400
1073,855,865,1720624,16569,512807,1302700
1074,833,863,1719793,16537,513670,1360600
1075,912,835,1718890,16605,514505,1495200
1076,915,878,1717965,16652,515383,1323400
1077,890,841,1717070,16706,516224,1381500
1078,897,862,1716165,16749,517086,1357600
1079,902,878,1715281,16755,517964,1266100
1080,892,887,1714362,16787,518851,1236100
1081,889,882,1713506,16761,519733,1257800
1082,894,919,1712582,16766,520652,1272500
1083,918,854,1711696,16798,521506,1345700
1084,919,893,1710772,16829,522399,1409900
1085,870,931,1709872,16798,523330,1240100
1086,864,911,1709032,16727,524241,1308500
1087,866,824,1708175,16760,525065,1362700
1088,875,865,1707292,16778,525930,1480800
1089,906,864,1706380,16826,526794,1279200
1090,897,875,1705490,16841,527669,1473400
1091,900,853,1704575,16903,528522,1524500
1092,929,892,1703674,16912,529414,1328600
1093,877,825,1702781,16980,530239,1344900
1094,918,871,1701842,17048,531110,1411800
1095,922,923,1700928,17039,532033,1307000
1096,940,876,1700002,17089,532909,1298100
1097,908,839,1699084,17168,533748,1420900
1098,881,870,1698210,17172,534618,1488300
1099,966,889,1697259,17234,535507,1677200
1100,933,918,1696315,17260,536425,1521100
1101,860,883,1695458,17234,537308,1506100
1102,892,843,1694570,17279,538151,1690300
1103,946,908,1693616,17325,539059,1622100
1104,905,904,1692706,17331,539963,1531900
1105,954,858,1691778,17401,540821,1541000
1106,892,896,1690863,17420,541717,1556700
1107,910,907,1689970,17406,542624,1644700
1108,891,911,1689060,17405,543535,1829900
1109,935,908,1688146,17411,544443,1510900
1110,930,880,1687189,17488,545323,1568300
1111,908,879,1686314,17484,546202,1580800
1112,930,899,1685378,17521,547101,1488200
1113,954,867,1684424,17608,547968,1382500
1114,931,937,1683506,17589,548905,1516800
1115,878,900,1682596,17599,549805,1382700
1116,942,1011,1681644,17540,550816,1506100
1117,899,912,1680756,17516,551728,1673800
1118,916,939,1679831,17502,552667,1683300
1119,925,881,1678929,17523,553548,1526200
1120,886,930,1678022,17500,554478,1365100
1121,942,927,1677113,17482,555405,1695600
1122,906,912,1676181,17502,556317,1673900
1123,935,884,1675267,17532,557201,1482500
1124,967,957,1674301,17541,558158,1839700
1125,948,944,1673338,17560,559102,1570200
1126,908,955,1672444,17499,560057,1866100
1127,950,949,1671480,17514,561006,1627200
1128,911,931,1670549,17514,561937,1432500
1129,937,904,1669615,17544,562841,1463300
1130,843,930,1668774,17455,563771,1907400
1131,954,903,1667850,17476,564674,1602600
1132,889,954,1666938,17434,565628,1572600
1133,876,888,1666046,17438,566516,1690600
1134,937,919,1665158,17407,567435,1983300
1135,878,883,1664228,17454,568318,2085500
1136,955,888,1663302,17492,569206,1688000
1137,891,905,1662410,17479,570111,1949100
1138,885,920,1661525,17444,571031,1675900
1139,894,891,1660606,17472,571922,1590400
1140,984,889,1659652,17537,572811,1525300
1141,924,955,1658727,17507,573766,1454600
1142,909,882,1657826,17526,574648,1475900
1143,935,915,1656864,17573,575563,1754000
1144,949,961,1655948,17528,576524,1450800
1145,902,883,1655022,17571,577407,1402000
1146,951,894,1654105,17594,578301,1451100
1147,911,907,1653178,17614,579208,1327300
1148,896,943,1652278,17571,580151,1370400
1149,926,904,1651346,17599,581055,1268400
1150,918,909,1650433,17603,581964,1251200
1151,915,937,1649493,17606,582901,1206700
1152,886,910,1648621,17568,583811,1197000
1153,856,928,1647744,17517,584739,1163200
1154,950,887,1646819,17555,585626,1240600
1155,911,892,1645909,17573,586518,1256700
1156,943,926,1644985,17571,587444,1241500
1157,968,918,1644006,17632,588362,1216900
1158,965,914,1643035,17689,589276,1195600
1159,965,942,1642084,17698,590218,1267100
1160,925,932,1641119,17731,591150,1238700
1161,939,930,1640200,17720,592080,1192500
1162,986,932,1639218,17770,593012,1260200
1163,906,934,1638307,17747,593946,1316300
1164,857,903,1637444,17707,594849,1320400
1165,896,969,1636558,17624,595818,1290900
1166,918,928,1635642,17612,596746,1320800
1167,902,919,1634737,17598,597665,1269200
1168,929,891,1633814,17630,598556,1391700
1169,952,903,1632867,17674,599459,1277800
1170,895,921,1631950,17670,600380,1236000
1171,938,941,1631026,17653,601321,1236900
1172,909,935,1630105,17639,602256,1241200
1173,947,900,1629177,17667,603156,1248600
1174,900,924,1628264,17656,604080,1285100
1175,961,949,1627314,17657,605029,1263800
1176,951,919,1626355,17697,605948,1355400
1177,956,912,1625418,17722,606860,1204100
1178,961,952,1624446,17742,607812,1223700
1179,954,949,1623517,17722,608761,1269800
1180,925,931,1622569,17739,609692,1179900
1181,964,921,1621594,17793,610613,1217200
1182,986,952,1620622,17813,611565,1250300
1183,950,916,1619671,17848,612481,1292500
1184,930,929,1618730,17860,613410,1233500
1185,962,896,1617773,17921,614306,1239900
1186,997,896,1616769,18029,615202,1157300
1187,980,865,1615801,18132,616067,1201300
1188,906,894,1614883,18156,616961,1180800
1189,999,944,1613901,18194,617905,1223800
1190,961,863,1612920,18312,618768,1260100
1191,955,1004,1611991,18237,619772,1328000
1192,993,971,1611004,18253,620743,1253900
1193,918,906,1610053,18298,621649,1181400
1194,948,956,1609122,18273,622605,1245800
1195,938,947,1608219,18229,623552,1155800
1196,951,893,1607219,18336,624445,1171800
1197,912,985,1606315,18255,625430,1224900
1198,947,934,1605374,18262,626364,1175500
1199,937,948,1604429,18259,627312,1155700
1200,944,971,1603490,18227,628283,1151900
1201,915,891,1602589,18237,629174,1144300
1202,899,975,1601671,18180,630149,1129900
1203,880,964,1600802,18085,631113,1121300
1204,923,953,1599880,18054,632066,1106100
1205,875,956,1598997,17981,633022,1131700
1206,919,978,1598096,17904,634000,1295600
1207,941,961,1597146,17893,634961,1175200
1208,952,969,1596178,17892,635930,1143200
1209,940,914,1595228,17928,636844,1221600
1210,929,966,1594325,17865,637810,1234300
1211,955,960,1593347,17883,638770,1223800
1212,961,937,1592408,17885,639707,1150200
1213,905,975,1591482,17836,640682,1107700
1214,899,905,1590581,17832,641587,1227700
1215,921,949,1589686,17778,642536,1165800
1216,948,925,1588718,17821,643461,1160100
1217,919,888,1587796,17855,644349,1139200
1218,905,855,1586893,17903,645204,1135100
1219,938,921,1585972,17903,646125,1211600
1220,895,908,1585056,17911,647033,1157100
1221,994,966,1584083,17918,647999,1222900
1222,1007,945,1583062,17994,648944,1207400
1223,900,961,1582147,17948,649905,1178300
1224,851,972,1581295,17828,650877,1143700
1225,946,953,1580390,17780,651830,1227500
1226,931,908,1579420,17842,652738,1222500
1227,931,986,1578508,17768,653724,1158500
1228,950,923,1577545,17808,654647,1111000
1229,888,908,1576661,17784,655555,1116800
1230,922,930,1575713,17802,656485,1148700
1231,911,925,1574826,17764,657410,1099400
1232,984,891,1573859,17840,658301,1117100
1233,897,904,1572945,17850,659205,1143500
1234,966,948,1571988,17859,660153,1171800
1235,927,907,1571045,17895,661060,1130100
1236,916,915,1570113,17912,661975,1142100
1237,937,912,1569203,17910,662887,1147500
1238,934,935,1568271,17907,663822,1180300
1239,899,946,1567356,17876,664768,1138100
1240,865,939,1566486,17807,665707,1114200
1241,938,945,1565567,17781,666652,1297600
1242,929,902,1564633,17813,667554,1153800
1243,962,926,1563668,17852,668480,1280000
1244,856,911,1562800,17809,669391,1230500
1245,942,891,1561887,17831,670282,1314100
1246,942,899,1560937,17882,671181,1214900
1247,964,931,1559964,17924,672112,1154000
1248,928,970,1559051,17867,673082,1175300
1249,938,874,1558118,17926,673956,1163600
1250,963,972,1557161,17911,674928,1097700
1251,1019,949,1556143,17980,675877,1092600
1252,993,900,1555134,18089,676777,1095100
1253,918,871,1554217,18135,677648,1173800
1254,988,1023,1553232,18097,678671,1120300
1255,964,928,1552291,18110,679599,1176200
1256,911,986,1551349,18066,680585,1199000
1257,962,951,1550412,18052,681536,1146400
1258,965,956,1549423,18085,682492,1271400
1259,966,917,1548485,18106,683409,1258000
1260,909,871,1547554,18166,684280,1329200
1261,945,961,1546612,18147,685241,1259300
1262,931,992,1545677,18090,686233,1196900
1263,987,955,1544701,18111,687188,1205500
1264,861,935,1543812,18065,688123,1194400
1265,934,925,1542897,18055,689048,1337600
1266,976,962,1541939,18051,690010,1234200
1267,955,950,1540968,18072,690960,1211500
1268,944,987,1540051,18002,691947,1229900
1269,893,909,1539132,18012,692856,1344500
1270,903,909,1538223,18012,693765,1265500
1271,927,895,1537286,18054,694660,1173100
1272,901,940,1536399,18001,695600,1247000
1273,896,937,1535501,17962,696537,1178500
1274,940,913,1534556,17994,697450,1185200
1275,938,947,1533635,17968,698397,1153000
1276,962,922,1532687,17994,699319,1195700
1277,974,954,1531692,18035,700273,1139200
1278,888,964,1530801,17962,701237,1151300
1279,939,948,1529861,17954,702185,1197500
1280,935,912,1528900,18003,703097,1176600
1281,926,953,1527972,17978,704050,1222800
1282,977,894,1527046,18010,704944,1268900
1283,999,961,1526043,18052,705905,1193900
1284,909,962,1525120,18013,706867,1451900
1285,938,940,1524170,18023,707807,1238500
1286,914,904,1523262,18027,708711,1209500
1287,918,1020,1522350,17919,709731,1261800
1288,998,972,1521361,17936,710703,1138700
1289,886,917,1520459,17921,711620,1174400
1290,926,951,1519541,17888,712571,1280900
1291,882,884,1518650,17895,713455,1289300
1292,936,918,1517705,17922,714373,1351900
1293,927,924,1516786,17917,715297,1309900
1294,921,916,1515849,17938,716213,1344100
1295,895,972,1514974,17841,717185,1555500
1296,900,878,1514068,17869,718063,1300600
1297,916,879,1513165,17893,718942,1322700
1298,914,983,1512235,17840,719925,1275800
1299,907,879,1511337,17859,720804,1172800
1300,865,935,1510439,17822,721739,1110600
1301,865,918,1509620,17723,722657,1115100
1302,873,889,1508715,17739,723546,1205300
1303,864,953,1507846,17655,724499,1229600
1304,1001,933,1506859,17709,725432,1194100
1305,888,900,1505957,17711,726332,1147700
1306,946,879,1505037,17752,727211,1165000
1307,914,916,1504122,17751,728127,1107700
1308,904,927,1503220,17726,729054,1120600
1309,901,912,1502316,17718,729966,1285500
1310,926,929,1501380,17725,730895,1168200
1311,908,930,1500482,17693,731825,1143400
1312,898,896,1499568,17711,732721,1106900
1313,938,909,1498659,17711,733630,1166300
1314,935,973,1497693,17704,734603,1240800
1315,883,896,1496808,17693,735499,1261400
1316,907,911,1495890,17700,736410,1133400
1317,927,917,1494971,17702,737327,1238100
1318,916,917,1494067,17689,738244,1267400
1319,902,936,1493166,17654,739180,1165300
1320,925,885,1492222,17713,740065,1125200
1321,941,964,1491304,17667,741029,1169800
1322,859,916,1490425,17630,741945,1288100
1323,931,938,1489518,17599,742883,1186300
1324,935,926,1488586,17605,743809,1284300
1325,903,927,1487652,17612,744736,1112800
1326,933,888,1486752,17624,745624,1190900
1327,916,896,1485830,17650,746520,1154000
1328,882,879,1484908,17693,747399,1148000
1329,912,1010,1484047,17544,748409,1149300
1330,921,935,1483126,17530,749344,1201800
1331,927,919,1482178,17559,750263,1173600
1332,907,903,1481234,17600,751166,1121700
1333,864,925,1480415,17494,752091,1148300
1334,905,926,1479508,17475,753017,1091000
1335,855,891,1478646,17446,753908,1080300
1336,947,875,1477719,17498,754783,1123300
1337,886,923,1476808,17486,755706,1269600
1338,839,900,1475969,17425,756606,1205600
1339,991,898,1475005,17491,757504,1213900
1340,971,864,1474016,17616,758368,1176000
1341,876,908,1473129,17595,759276,1228000
1342,961,923,1472181,17620,760199,1217700
1343,971,912,1471233,17656,761111,1225800
1344,928,873,1470294,17722,761984,1174200
1345,1017,955,1469291,17770,762939,1144600
1346,955,922,1468323,17816,763861,1284100
1347,904,917,1467398,17824,764778,1275300
1348,927,909,1466491,17822,765687,1253300
1349,901,933,1465584,17796,766620,1191200
1350,935,983,1464641,17756,767603,1205200
1351,941,954,1463714,17729,768557,1355200
1352,896,990,1462808,17645,769547,1104700
1353,900,905,1461915,17633,770452,1215300
1354,918,885,1460980,17683,771337,1182600
1355,965,953,1460034,17676,772290,1151400
1356,863,916,1459141,17653,773206,1199200
1357,957,947,1458204,17643,774153,1179000
1358,915,942,1457277,17628,775095,1165000
1359,936,946,1456356,17603,776041,1210300
1360,924,963,1455422,17574,777004,1199300
1361,922,878,1454506,17612,777882,1230900
1362,906,884,1453587,17647,778766,1247400
1363,914,888,1452685,17661,779654,1220200
1364,886,904,1451765,17677,780558,1162400
1365,905,886,1450882,17674,781444,1116000
1366,949,937,1449965,17654,782381,1154600
1367,906,877,1449052,17690,783258,1119300
1368,945,854,1448111,17777,784112,1104400
1369,988,970,1447131,17787,785082,1112000
1370,860,898,1446225,17795,785980,1097400
1371,900,922,1445337,17761,786902,1202700
1372,877,922,1444470,17706,787824,1183600
1373,871,973,1443599,17604,788797,1155800
1374,861,949,1442729,17525,789746,1111300
1375,842,922,1441894,17438,790668,1133700
1376,836,874,1441036,17422,791542,1119700
1377,891,908,1440155,17395,792450,1250300
1378,881,898,1439266,17386,793348,1137500
1379,926,905,1438374,17373,794253,1304200
1380,906,880,1437454,17413,795133,1100600
1381,825,864,1436605,17398,795997,1105800
1382,860,906,1435744,17353,796903,1061400
1383,867,925,1434888,17284,797828,1138200
1384,888,922,1434028,17222,798750,1059400
1385,894,883,1433130,17237,799633,1070400
1386,856,879,1432269,17219,800512,1235800
1387,868,899,1431396,17193,801411,1193800
1388,888,872,1430504,17213,802283,1178900
1389,937,894,1429570,17253,803177,1173100
1390,928,927,1428642,17254,804104,1181700
1391,889,895,1427727,17274,804999,1195300
1392,945,892,1426788,17321,805891,1133600
1393,922,962,1425884,17263,806853,1193500
1394,910,889,1424973,17285,807742,1225200
1395,872,873,1424104,17281,808615,1284500
1396,969,885,1423149,17351,809500,1370400
1397,943,900,1422215,17385,810400,1294400
1398,985,883,1421223,17494,811283,1287600
1399,944,925,1420276,17516,812208,1280700
1400,948,906,1419345,17541,813114,1273200
1401,967,889,1418333,17664,814003,1303900
1402,931,863,1417425,17709,814866,1271100
1403,999,877,1416423,17834,815743,1543300
1404,985,1002,1415458,17797,816745,1394100
1405,923,951,1414510,17794,817696,1434500
1406,912,902,1413588,17814,818598,1366800
1407,965,974,1412660,17768,819572,1267900
1408,938,948,1411738,17742,820520,1219500
1409,892,931,1410815,17734,821451,1446400
1410,897,916,1409892,17741,822367,1206200
1411,935,921,1408986,17726,823288,1168800
1412,875,915,1408097,17700,824203,1291800
1413,929,891,1407154,17752,825094,1260200
1414,947,920,1406258,17728,826014,1206700
1415,937,923,1405270,17793,826937,1266900
1416,987,915,1404338,17810,827852,1206600
1417,952,983,1403351,17814,828835,1193100
1418,963,936,1402406,17823,829771,1157700
1419,996,906,1401403,17920,830677,1115600
1420,914,959,1400488,17876,831636,1177000
1421,905,917,1399563,17884,832553,1140000
1422,891,917,1398694,17836,833470,1063900
1423,991,927,1397698,17905,834397,1125000
1424,960,927,1396742,17934,835324,1246800
1425,962,908,1395783,17985,836232,1086700
1426,918,941,1394839,17988,837173,1170600
1427,916,904,1393927,17996,838077,1139600
1428,895,977,1393020,17926,839054,1073900
1429,905,914,1392127,17905,839968,1134000
1430,827,930,1391316,17786,840898,1090500
1431,897,914,1390395,17793,841812,1106400
1432,873,929,1389538,17721,842741,1070200
1433,853,953,1388689,17617,843694,1169800
1434,867,914,1387793,17599,844608,1147800
1435,869,904,1386944,17544,845512,1143000
1436,915,924,1386026,17538,846436,1086800
1437,884,909,1385138,17517,847345,1069100
1438,864,909,1384276,17470,848254,1172100
1439,871,912,1383391,17443,849166,1134700
1440,895,890,1382507,17437,850056,1085500
1441,865,856,1381648,17440,850912,1184100
1442,935,876,1380725,17487,851788,1171800
1443,829,944,1379859,17409,852732,1144300
1444,937,827,1378935,17506,853559,1096900
1445,903,871,1378052,17518,854430,1075300
1446,960,907,1377130,17533,855337,1034900
1447,919,921,1376175,17567,856258,1070700
1448,855,927,1375308,17507,857185,1142700
1449,916,865,1374412,17538,858050,1147000
1450,936,921,1373469,17560,858971,1194600
1451,924,935,1372533,17561,859906,1082600
1452,896,838,1371650,17606,860744,1098000
1453,879,885,1370757,17614,861629,1238900
1454,896,980,1369884,17507,862609,1153900
1455,909,921,1368973,17497,863530,1344300
1456,954,886,1368021,17563,864416,1188400
1457,951,871,1367052,17661,865287,1080500
1458,952,994,1366097,17622,866281,1166800
1459,910,850,1365203,17666,867131,1061800
1460,903,950,1364292,17627,868081,1082000
1461,925,929,1363355,17635,869010,1142400
1462,975,935,1362405,17650,869945,1496600
1463,915,854,1361475,17726,870799,1155600
1464,940,979,1360530,17692,871778,1156600
1465,863,902,1359652,17668,872680,1189200
1466,996,882,1358671,17767,873562,1213500
1467,869,930,1357804,17704,874492,1458400
1468,941,975,1356874,17659,875467,1295000
1469,851,872,1356001,17660,876339,1310500
1470,901,923,1355118,17620,877262,1256400
1471,937,873,1354194,17671,878135,1262500
1472,844,889,1353307,17669,879024,1369900
1473,963,928,1352344,17704,879952,1365300
1474,902,917,1351460,17671,880869,1275200
1475,922,967,1350555,17609,881836,1264900
1476,943,861,1349616,17687,882697,1322100
1477,969,892,1348643,17768,883589,1219600
1478,936,882,1347695,17834,884471,1126000
1479,894,906,1346807,17816,885377,1417100
1480,957,989,1345843,17791,886366,1250800
1481,905,910,1344932,17792,887276,1234200
1482,961,921,1344013,17790,888197,1154900
1483,928,933,1343052,17818,889130,1134200
1484,893,983,1342137,17750,890113,1094200
1485,911,888,1341255,17744,891001,1110500
1486,973,959,1340266,17774,891960,1144100
1487,897,935,1339383,17722,892895,1101900
1488,856,909,1338515,17681,893804,1343800
1489,913,894,1337605,17697,894698,1083700
1490,902,937,1336708,17657,895635,1031500
1491,938,925,1335773,17667,896560,1097400
1492,1018,943,1334772,17725,897503,1047600
1493,963,862,1333811,17824,898365,1112700
1494,911,937,1332880,17818,899302,1015600
1495,935,994,1331957,17747,900296,1033700
1496,884,934,1331050,17720,901230,1007800
1497,937,901,1330126,17743,902131,1035600
1498,921,903,1329194,17772,903034,1200300
1499,896,934,1328311,17721,903968,1087900
1500,913,944,1327384,17704,904912,1065700
1501,883,886,1326498,17704,905798,1048000
1502,951,881,1325573,17748,906679,999600
1503,946,910,1324623,17788,907589,1031000
1504,915,936,1323700,17775,908525,1153700
1505,900,887,1322780,17808,909412,1180800
1506,956,948,1321856,17784,910360,1182700
1507,928,897,1320910,17833,911257,1301500
1508,916,915,1320010,17818,912172,1271700
1509,996,932,1319004,17892,913104,1256600
1510,988,909,1318035,17952,914013,1201900
1511,912,935,1317094,17958,914948,1269100
1512,964,944,1316162,17946,915892,1614400
1513,924,870,1315208,18030,916762,1386500
1514,961,884,1314292,18062,917646,1209000
1515,928,977,1313318,18059,918623,1238500
1516,995,937,1312347,18093,919560,1310500
1517,907,948,1311406,18086,920508,1255700
1518,961,957,1310463,18072,921465,1261400
1519,987,881,1309479,18175,922346,1143300
1520,922,919,1308560,18175,923265,1265400
1521,964,962,1307594,18179,924227,1209900
1522,888,905,1306682,18186,925132,1145300
1523,927,941,1305773,18154,926073,1218900
1524,954,932,1304822,18173,927005,1147300
1525,942,940,1303883,18172,927945,1172800
1526,860,930,1303006,18119,928875,1147200
1527,914,1042,1302079,18004,929917,1111700
1528,933,912,1301138,18033,930829,1109500
1529,959,934,1300219,18018,931763,1089800
1530,895,897,1299300,18040,932660,1156000
1531,943,881,1298378,18081,933541,1137500
1532,931,904,1297453,18102,934445,1119400
1533,906,896,1296532,18127,935341,1132900
1534,910,936,1295625,18098,936277,1131200
1535,926,970,1294702,18051,937247,1384100
1536,876,948,1293825,17980,938195,1146900
1537,949,909,1292875,18021,939104,1129800
1538,963,889,1291911,18096,939993,1109200
1539,877,934,1291044,18029,940927,1167300
1540,919,987,1290119,17967,941914,1193500
1541,893,913,1289212,17961,942827,1288800
1542,971,897,1288259,18017,943724,1311200
1543,870,945,1287378,17953,944669,1365400
1544,884,915,1286469,17947,945584,1266200
1545,868,943,1285616,17857,946527,1287400
1546,861,944,1284771,17758,947471,1268700
1547,883,951,1283868,17710,948422,1229200
1548,889,874,1282993,17711,949296,1199800
1549,879,894,1282105,17705,950190,1208700
1550,885,884,1281202,17724,951074,1202000
1551,824,949,1280399,17578,952023,1195900
1552,890,946,1279506,17525,952969,1326300
1553,926,938,1278604,17489,953907,1408500
1554,890,871,1277691,17531,954778,1390300
1555,876,936,1276818,17468,955714,1351200
1556,875,924,1275937,17425,956638,1339800
1557,835,896,1275104,17362,957534,1377800
1558,864,932,1274232,17302,958466,1625500
1559,885,887,1273370,17277,959353,1428100
1560,864,916,1272483,17248,960269,1260900
1561,861,878,1271637,17216,961147,1250600
1562,951,932,1270676,17245,962079,1303700
1563,883,893,1269806,17222,962972,1227300
1564,852,902,1268942,17184,963874,1268200
1565,857,894,1268065,17167,964768,1481200
1566,857,869,1267249,17114,965637,1276100
1567,844,901,1266369,17093,966538,1231100
1568,871,893,1265497,17072,967431,1347200
1569,845,926,1264652,16991,968357,1201900
1570,869,819,1263801,17023,969176,1252500
1571,812,935,1262987,16902,970111,1234100
1572,854,868,1262131,16890,970979,1127900
1573,812,888,1261323,16810,971867,1227300
1574,832,878,1260485,16770,972745,1144200
1575,807,917,1259677,16661,973662,1232200
1576,834,909,1258863,16566,974571,1221300
1577,818,837,1258025,16567,975408,1295500
1578,849,834,1257175,16583,976242,1215300
1579,837,820,1256348,16590,977062,1118600
1580,788,897,1255541,16500,977959,1076900
1581,784,845,1254781,16415,978804,1081300
1582,861,869,1253907,16420,979673,1085400
1583,877,823,1253035,16469,980496,1104200
1584,852,875,1252192,16437,981371,1123000
1585,871,882,1251305,16442,982253,1187400
1586,822,873,1250499,16375,983126,1142100
1587,823,849,1249652,16373,983975,1128200
1588,851,797,1248806,16422,984772,1090200
1589,874,863,1247939,16426,985635,1082700
1590,862,859,1247087,16419,986494,1041500
1591,867,840,1246215,16451,987334,1122100
1592,837,826,1245350,16490,988160,1360500
1593,851,861,1244527,16452,989021,1118200
1594,848,901,1243680,16398,989922,1090100
1595,830,888,1242839,16351,990810,1134100
1596,827,872,1242010,16308,991682,1092600
1597,813,862,1241208,16248,992544,1053200
1598,825,811,1240369,16276,993355,1115300
1599,818,893,1239577,16175,994248,1216700
1600,886,823,1238688,16241,995071,1098200
1601,845,822,1237836,16271,995893,1203800
1602,831,836,1236996,16275,996729,1090900
1603,827,848,1236151,16272,997577,1088400
1604,857,819,1235334,16270,998396,1141200
1605,821,850,1234483,16271,999246,1110400
1606,831,863,1233672,16219,1000109,1149000
1607,829,859,1232811,16221,1000968,1127800
1608,818,870,1232007,16155,1001838,1135400
1609,857,819,1231168,16175,1002657,1095800
1610,863,845,1230290,16208,1003502,1143700
1611,897,884,1229407,16207,1004386,1140600
1612,860,906,1228528,16180,1005292,1166800
1613,858,845,1227688,16175,1006137,1193400
1614,818,856,1226859,16148,1006993,1099200
1615,853,803,1226009,16195,1007796,1223000
1616,837,891,1225162,16151,1008687,1159200
1617,803,851,1224342,16120,1009538,1178200
1618,784,851,1223588,16023,1010389,1124500
1619,798,858,1222769,15984,1011247,1111000
1620,846,810,1221941,16002,1012057,1616400
1621,805,875,1221109,15959,1012932,1179900
1622,783,785,1220347,15936,1013717,1153800
1623,703,793,1219613,15877,1014510,1117400
1624,850,853,1218790,15847,1015363,1100600
1625,811,819,1217971,15847,1016182,1109900
1626,826,842,1217174,15802,1017024,1195600
1627,835,819,1216315,15842,1017843,1096100
1628,828,806,1215502,15849,1018649,1131300
1629,862,823,1214628,15900,1019472,1728400
1630,771,828,1213846,15854,1020300,1352700
1631,795,813,1213051,15836,1021113,1343200
1632,795,816,1212260,15811,1021929,1132200
1633,822,811,1211427,15833,1022740,1242100
1634,848,781,1210588,15891,1023521,1234200
1635,831,837,1209782,15860,1024358,1203400
1636,853,795,1208912,15935,1025153,1254500
1637,808,844,1208097,15906,1025997,1238400
1638,863,757,1207251,15995,1026754,1255300
1639,825,848,1206422,15976,1027602,1214800
1640,814,828,1205602,15968,1028430,1134600
1641,784,842,1204798,15930,1029272,1346600
1642,806,812,1204015,15901,1030084,1167500
1643,820,823,1203197,15896,1030907,1152800
1644,831,882,1202361,15850,1031789,1159500
1645,836,865,1201525,15821,1032654,1102500
1646,830,805,1200710,15831,1033459,1209400
1647,826,816,1199863,15862,1034275,1193800
1648,840,795,1199020,15910,1035070,1107500
1649,801,863,1198231,15836,1035933,1069600
1650,866,848,1197399,15820,1036781,1104000
1651,794,826,1196572,15821,1037607,1174200
1652,779,869,1195782,15742,1038476,1099500
1653,763,777,1195013,15734,1039253,1240200
1654,866,795,1194169,15783,1040048,1159200
1655,811,848,1193362,15742,1040896,1111700
1656,780,835,1192585,15684,1041731,1129800
1657,828,843,1191755,15671,1042574,1149700
1658,787,843,1190949,15634,1043417,1189000
1659,811,823,1190152,15608,1044240,1166100
1660,824,806,1189307,15647,1045046,1170300
1661,827,801,1188505,15648,1045847,1103300
1662,739,827,1187747,15579,1046674,1240900
1663,812,827,1186941,15558,1047501,1277100
1664,777,814,1186158,15527,1048315,1293300
1665,768,818,1185396,15471,1049133,1318500
1666,829,805,1184576,15486,1049938,1190000
1667,738,831,1183799,15432,1050769,1134700
1668,803,820,1183017,15394,1051589,1087600
1669,749,843,1182285,15283,1052432,1220800
1670,746,768,1181499,15301,1053200,1379400
1671,819,782,1180708,15310,1053982,1245500
1672,815,789,1179898,15331,1054771,1202700
1673,756,769,1179127,15333,1055540,1224000
1674,792,821,1178342,15297,1056361,1359400
1675,760,766,1177585,15288,1057127,1432300
1676,744,828,1176843,15202,1057955,1174900
1677,813,798,1176017,15230,1058753,1200500
1678,756,796,1175270,15181,1059549,1201700
1679,741,811,1174513,15127,1060360,1307500
1680,742,763,1173783,15094,1061123,1235300
1681,801,797,1172993,15087,1061920,1338300
1682,761,760,1172214,15106,1062680,1332200
1683,816,822,1171411,15087,1063502,1224600
1684,805,724,1170621,15153,1064226,1262200
1685,791,786,1169802,15186,1065012,1270600
1686,707,736,1169097,15155,1065748,1126600
1687,817,829,1168300,15123,1066577,1108700
1688,773,781,1167495,15147,1067358,1166100
1689,782,775,1166738,15129,1068133,1103700
1690,742,776,1165965,15126,1068909,1094500
1691,776,796,1165209,15086,1069705,1137900
1692,763,830,1164453,15012,1070535,1225200
1693,788,761,1163678,15026,1071296,1241900
1694,782,795,1162854,15055,1072091,1157500
1695,781,781,1162097,15031,1072872,1082500
1696,774,778,1161311,15039,1073650,1175400
1697,758,751,1160572,15027,1074401,1145300
1698,783,779,1159790,15030,1075180,1161900
1699,833,757,1158933,15130,1075937,1125500
1700,838,783,1158133,15147,1076720,1195400
1701,787,789,1157334,15157,1077509,1077700
1702,757,804,1156569,15118,1078313,1096000
1703,801,775,1155773,15139,1079088,1240800
1704,775,776,1154989,15147,1079864,1168600
1705,800,855,1154197,15084,1080719,1135600
1706,727,778,1153445,15058,1081497,1134300
1707,811,778,1152671,15054,1082275,1113000
1708,821,793,1151839,15093,1083068,1220300
1709,762,747,1151053,15132,1083815,1091000
1710,750,833,1150315,15037,1084648,1137200
1711,788,832,1149530,14990,1085480,1078700
1712,781,808,1148753,14959,1086288,1103100
1713,788,787,1147974,14951,1087075,1203400
1714,749,741,1147200,14984,1087816,1082200
1715,750,816,1146472,14896,1088632,1222000
1716,752,794,1145697,14877,1089426,1144400
1717,801,747,1144921,14906,1090173,1150500
1718,745,782,1144157,14888,1090955,1126500
1719,741,777,1143412,14856,1091732,1104600
1720,851,766,1142609,14893,1092498,1251600
1721,783,816,1141776,14910,1093314,1202600
1722,751,737,1141030,14919,1094051,1234000
1723,798,763,1140249,14937,1094814,1145100
1724,801,823,1139434,14929,1095637,1190700
1725,833,787,1138617,14959,1096424,1240700
1726,776,805,1137839,14932,1097229,1243500
1727,792,785,1137065,14921,1098014,1242900
1728,820,739,1136203,15044,1098753,1304300
1729,768,764,1135436,15047,1099517,1168700
1730,840,772,1134634,15077,1100289,1234300
1731,828,798,1133808,15105,1101087,1214400
1732,818,757,1132989,15167,1101844,1222600
1733,824,804,1132157,15195,1102648,1272300
1734,823,863,1131317,15172,1103511,1161400
1735,792,771,1130531,15187,1104282,1119800
1736,797,775,1129726,15217,1105057,1122600
1737,828,857,1128903,15183,1105914,1118900
1738,855,768,1128054,15264,1106682,1147800
1739,821,811,1127232,15275,1107493,1189100
1740,795,746,1126451,15310,1108239,1154500
1741,799,820,1125656,15285,1109059,1151300
1742,792,782,1124849,15310,1109841,1057000
1743,820,811,1124027,15321,1110652,1213300
1744,757,798,1123246,15304,1111450,1206900
1745,852,794,1122436,15320,1112244,1207500
1746,806,830,1121607,15319,1113074,1222300
1747,815,816,1120802,15308,1113890,1196900
1748,831,789,1119978,15343,1114679,1112700
1749,842,799,1119126,15396,1115478,1151900
1750,829,792,1118288,15442,1116270,1171200
1751,814,789,1117457,15484,1117059,1123700
1752,848,807,1116661,15473,1117866,1119500
1753,799,846,1115816,15472,1118712,1297400
1754,779,835,1115043,15410,1119547,1276100
1755,790,825,1114267,15361,1120372,1225400
1756,713,804,1113548,15276,1121176,1206300
1757,830,823,1112737,15264,1121999,1180400
1758,777,769,1111943,15289,1122768,1115100
1759,820,800,1111140,15292,1123568,1149900
1760,855,813,1110270,15349,1124381,1339500
1761,769,796,1109487,15336,1125177,1236400
1762,805,787,1108685,15351,1125964,1225400
1763,759,770,1107909,15357,1126734,1146800
1764,772,765,1107174,15327,1127499,1270200
1765,766,764,1106395,15342,1128263,1353700
1766,747,793,1105640,15304,1129056,1392700
1767,801,759,1104858,15327,1129815,1191200
1768,779,807,1104071,15307,1130622,1176400
1769,765,816,1103298,15264,1131438,1142200
1770,745,786,1102561,15215,1132224,1176200
1771,811,779,1101743,15254,1133003,1244300
1772,799,766,1100937,15294,1133769,1239400
1773,826,776,1100146,15309,1134545,1144300
1774,808,797,1099333,15325,1135342,1235400
1775,800,748,1098533,15377,1136090,1168500
1776,836,845,1097688,15377,1136935,1159300
1777,852,790,1096855,15420,1137725,1285000
1778,791,778,1096028,15469,1138503,1270200
1779,843,822,1095211,15464,1139325,1189400
1780,801,815,1094380,15480,1140140,1230700
1781,774,801,1093600,15459,1140941,1451300
1782,751,871,1092870,15318,1141812,1300700
1783,719,795,1092137,15256,1142607,1235300
1784,706,790,1091430,15173,1143397,1203400
1785,826,779,1090625,15199,1144176,1341000
1786,731,785,1089874,15165,1144961,1213000
1787,699,769,1089177,15093,1145730,1148900
1788,722,755,1088475,15040,1146485,1231300
1789,752,783,1087701,15031,1147268,1139300
1790,788,759,1086912,15061,1148027,1177800
1791,784,773,1086138,15062,1148800,1132800
1792,744,808,1085382,15010,1149608,1111600
1793,741,757,1084657,14978,1150365,1108800
1794,761,747,1083890,14998,1151112,1211500
1795,804,760,1083089,15039,1151872,1150700
1796,712,748,1082359,15021,1152620,1090600
1797,754,761,1081614,15005,1153381,1209300
1798,799,743,1080819,15057,1154124,1315800
1799,842,759,1080007,15110,1154883,1323400
1800,780,741,1079198,15178,1155624,1235800
1801,783,837,1078422,15117,1156461,1209900
1802,715,748,1077694,15097,1157209,1263200
1803,760,783,1076962,15046,1157992,1189300
1804,772,765,1076173,15070,1158757,1235200
1805,773,779,1075402,15062,1159536,1238300
1806,758,778,1074644,15042,1160314,1296700
1807,819,778,1073828,15080,1161092,1177200
1808,751,775,1073081,15052,1161867,1209900
1809,778,785,1072287,15061,1162652,1149100
1810,794,716,1071497,15135,1163368,1170000
1811,777,767,1070715,15150,1164135,1125400
1812,748,781,1069980,15104,1164916,1128100
1813,725,762,1069240,15082,1165678,1245000
1814,768,772,1068487,15063,1166450,1368900
1815,761,819,1067716,15015,1167269,1256200
1816,734,818,1066993,14920,1168087,1244900
1817,812,822,1066190,14901,1168909,1368500
1818,780,797,1065392,14902,1169706,1398500
1819,725,814,1064667,14813,1170520,1358700
1820,686,739,1063987,14754,1171259,1302400
1821,728,773,1063237,14731,1172032,1359700
1822,720,765,1062524,14679,1172797,1199000
1823,751,756,1061783,14664,1173553,1189300
1824,730,741,1061043,14663,1174294,1243200
1825,764,745,1060281,14680,1175039,1302000
1826,708,788,1059569,14604,1175827,1380500
1827,787,711,1058803,14659,1176538,1159100
1828,783,764,1058005,14693,1177302,1189100
1829,704,665,1057309,14724,1177967,1091700
1830,731,819,1056574,14640,1178786,1119400
1831,705,759,1055843,14612,1179545,1224500
1832,691,725,1055175,14555,1180270,1180900
1833,690,759,1054490,14481,1181029,1154300
1834,719,744,1053759,14468,1181773,1426500
1835,677,696,1053073,14458,1182469,1535900
1836,711,778,1052356,14397,1183247,1433100
1837,711,741,1051668,14344,1183988,1231500
1838,680,743,1050968,14301,1184731,1140900
1839,733,758,1050251,14260,1185489,1272600
1840,679,766,1049556,14189,1186255,1259300
1841,698,753,1048850,14142,1187008,1270700
1842,706,753,1048156,14083,1187761,1220300
1843,695,706,1047469,14064,1188467,1285800
1844,757,720,1046738,14075,1189187,1235600
1845,727,705,1045983,14125,1189892,1193200
1846,685,738,1045304,14066,1190630,1134400
1847,724,701,1044564,14105,1191331,1255100
1848,753,749,1043840,14080,1192080,1352800
1849,694,757,1043122,14041,1192837,1204800
1850,678,738,1042452,13973,1193575,1300300
1851,734,724,1041713,13988,1194299,1234400
1852,692,731,1041032,13938,1195030,1251400
1853,654,702,1040363,13905,1195732,1134700
1854,716,701,1039639,13928,1196433,1134100
1855,699,686,1038944,13937,1197119,1120100
1856,697,743,1038267,13871,1197862,1104100
1857,736,703,1037533,13902,1198565,1153500
1858,682,679,1036835,13921,1199244,1146000
1859,688,769,1036143,13844,1200013,1467800
1860,715,678,1035415,13894,1200691,1406900
1861,729,701,1034702,13906,1201392,1186600
1862,772,712,1033951,13945,1202104,1205900
1863,720,725,1033215,13956,1202829,1190600
1864,696,706,1032527,13938,1203535,1219500
1865,687,736,1031829,13900,1204271,1179700
1866,701,720,1031143,13866,1204991,1165000
1867,714,754,1030408,13847,1205745,1173100
1868,705,695,1029723,13837,1206440,1298400
1869,765,694,1028949,13917,1207134,1238800
1870,659,746,1028293,13827,1207880,1206600
1871,756,742,1027541,13837,1208622,1144700
1872,725,688,1026800,13890,1209310,1185500
1873,736,711,1026099,13880,1210021,1196600
1874,645,737,1025408,13834,1210758,1138800
1875,721,678,1024700,13864,1211436,1158800
1876,744,681,1023975,13908,1212117,1163100
1877,764,697,1023193,13993,1212814,1132300
1878,746,736,1022459,13991,1213550,1174400
1879,739,749,1021693,14008,1214299,1193500
1880,730,725,1020966,14010,1215024,1200000
1881,726,761,1020274,13941,1215785,1316900
1882,713,689,1019560,13966,1216474,1452300
1883,726,689,1018818,14019,1217163,1836500
1884,747,752,1018058,14027,1217915,1765700
1885,743,745,1017352,13988,1218660,1831900
1886,729,708,1016620,14012,1219368,1925500
1887,698,706,1015910,14016,1220074,1680700
1888,706,708,1015197,14021,1220782,1498900
1889,689,749,1014477,13992,1221531,1408900
1890,720,768,1013791,13910,1222299,1581100
1891,732,673,1013039,13989,1222972,1546100
1892,713,741,1012340,13947,1223713,1600600
1893,721,756,1011619,13912,1224469,1401900
1894,742,690,1010895,13946,1225159,1375800
1895,761,731,1010129,13981,1225890,1558000
1896,693,750,1009426,13934,1226640,1510700
1897,686,693,1008737,13930,1227333,1358100
1898,723,689,1008005,13973,1228022,1362000
1899,695,723,1007328,13927,1228745,1478900
1900,739,724,1006597,13934,1229469,1635800
1901,771,710,1005817,14004,1230179,1542900
1902,727,678,1005079,14064,1230857,2133400
1903,732,728,1004360,14055,1231585,1411100
1904,768,719,1003589,14107,1232304,1609500
1905,717,754,1002855,14087,1233058,1476600
1906,726,779,1002147,14016,1233837,1416200
1907,683,716,1001461,13986,1234553,1431900
1908,678,728,1000777,13942,1235281,1371400
1909,740,728,1000056,13935,1236009,1678600
1910,695,741,999361,13889,1236750,1555800
1911,688,715,998662,13873,1237465,1520000
1912,714,705,997956,13874,1238170,2328000
1913,758,701,997193,13936,1238871,2226400
1914,687,722,996498,13909,1239593,2101800
1915,705,726,995790,13891,1240319,2115600
1916,663,744,995136,13801,1241063,1834300
1917,678,761,994435,13741,1241824,2285600
1918,778,668,993702,13806,1242492,2036600
1919,703,699,992982,13827,1243191,1793700
1920,730,675,992267,13867,1243866,1956500
1921,711,745,991542,13847,1244611,2574300
1922,737,661,990819,13909,1245272,1880700
1923,723,687,990063,13978,1245959,2026100
1924,664,779,989397,13865,1246738,1734200
1925,699,757,988700,13805,1247495,1700000
1926,730,707,987980,13818,1248202,1539200
1927,717,743,987264,13791,1248945,1398500
1928,693,771,986558,13726,1249716,1624200
1929,671,716,985883,13685,1250432,1667300
1930,697,680,985192,13696,1251112,1425200
1931,695,690,984498,13700,1251802,1438700
1932,724,688,983801,13709,1252490,1397000
1933,707,695,983057,13758,1253185,1473200
1934,725,746,982350,13719,1253931,1284300
1935,723,710,981630,13729,1254641,1441100
1936,670,746,980938,13675,1255387,1305100
1937,724,681,980216,13716,1256068,1430400
1938,746,736,979495,13701,1256804,1286200
1939,692,721,978786,13689,1257525,1271100
1940,655,747,978128,13600,1258272,1340100
1941,658,691,977473,13564,1258963,1360500
1942,713,693,976748,13596,1259656,1291000
1943,650,713,976095,13536,1260369,1289800
1944,665,711,975443,13477,1261080,1470300
1945,699,669,974754,13497,1261749,1384300
1946,720,683,974037,13531,1262432,1320900
1947,702,727,973312,13529,1263159,1339300
1948,696,655,972638,13548,1263814,1427500
1949,688,664,971947,13575,1264478,1214500
1950,641,688,971304,13530,1265166,1185600
1951,612,704,970689,13441,1265870,1125100
1952,643,713,970029,13388,1266583,1242300
1953,645,696,969368,13353,1267279,1580900
1954,694,702,968712,13307,1267981,1262800
1955,699,699,967991,13329,1268680,1552100
1956,686,698,967324,13298,1269378,1507900
1957,667,712,966653,13257,1270090,1344600
1958,671,694,965995,13221,1270784,1547900
1959,691,719,965299,13198,1271503,1430800
1960,690,680,964604,13213,1272183,1559500
1961,666,714,963930,13173,1272897,1269100
1962,611,609,963298,13196,1273506,1346100
1963,686,680,962631,13183,1274186,1298800
1964,685,695,961943,13176,1274881,1215300
1965,685,662,961261,13196,1275543,1330500
1966,660,728,960596,13133,1276271,1448900
1967,671,685,959941,13103,1276956,1218400
1968,651,671,959305,13068,1277627,1223400
1969,658,660,958590,13123,1278287,1369300
1970,647,670,957980,13063,1278957,1476700
1971,688,683,957299,13061,1279640,1237300
1972,676,643,956603,13114,1280283,1228800
1973,634,668,955980,13069,1280951,1390400
1974,683,701,955299,13049,1281652,1198400
1975,672,668,954613,13067,1282320,1155600
1976,695,635,953936,13109,1282955,1185900
1977,618,680,953288,13077,1283635,1517000
1978,646,662,952653,13050,1284297,1334700
1979,648,663,952019,13021,1284960,1228100
1980,644,670,951356,13014,1285630,1312000
1981,652,684,950717,12969,1286314,1408700
1982,727,678,949998,13010,1286992,1222000
1983,597,644,949382,12982,1287636,1439300
1984,632,676,948763,12925,1288312,1310200
1985,632,674,948121,12893,1288986,1253700
1986,654,654,947479,12881,1289640,1341000
1987,676,679,946806,12875,1290319,1831200
1988,663,644,946140,12897,1290963,1263300
1989,642,711,945487,12839,1291674,1340000
1990,615,698,944868,12760,1292372,1325000
1991,621,627,944247,12754,1292999,1249300
1992,640,690,943618,12693,1293689,1237200
1993,640,663,942977,12671,1294352,1145800
1994,639,653,942340,12655,1295005,1103400
1995,603,679,941725,12591,1295684,1143300
1996,663,646,941072,12598,1296330,1111300
1997,638,649,940441,12580,1296979,1123300
1998,602,662,939824,12535,1297641,1106500
1999,575,661,939236,12462,1298302,1127700
2000,667,625,938579,12494,1298927,1112800
2001,605,663,937973,12437,1299590,1114700
2002,630,646,937367,12397,1300236,1174500
2003,630,623,936711,12430,1300859,1077600
2004,652,653,936073,12415,1301512,1174600
2005,627,642,935438,12408,1302154,1222200
2006,617,659,934835,12352,1302813,1393900
2007,673,659,934145,12383,1303472,1280400
2008,640,647,933539,12342,1304119,1166200
2009,608,649,932897,12335,1304768,1172700
2010,600,652,932306,12274,1305420,1287400
2011,641,658,931663,12259,1306078,1253900
2012,647,659,931012,12251,1306737,1367700
2013,657,694,930362,12207,1307431,1205600
2014,653,630,929715,12224,1308061,1228400
2015,658,654,929034,12251,1308715,1249600
2016,597,646,928428,12211,1309361,1225000
2017,620,645,927826,12168,1310006,1286900
2018,636,630,927210,12154,1310636,1402500
2019,596,680,926592,12092,1311316,1226100
2020,639,647,925961,12076,1311963,1256500
2021,613,620,925328,12089,1312583,1171400
2022,604,601,924742,12074,1313184,1240400
2023,671,645,924078,12093,1313829,1328000
2024,618,612,923452,12107,1314441,1299300
2025,601,670,922836,12053,1315111,1367600
2026,625,610,922235,12044,1315721,1357100
2027,584,594,921630,12055,1316315,1253700
2028,597,593,921032,12060,1316908,1276300
2029,669,608,920390,12094,1317516,1216700
2030,592,634,919795,12055,1318150,1481500
2031,601,626,919174,12050,1318776,1242200
2032,627,586,918569,12069,1319362,1257900
2033,604,614,917948,12076,1319976,1185600
2034,604,617,917357,12050,1320593,1314600
2035,613,657,916734,12016,1321250,1268800
2036,619,649,916136,11965,1321899,1153700
2037,607,631,915517,11953,1322530,1175500
2038,636,609,914864,11997,1323139,1249800
2039,577,618,914285,11958,1323757,1262200
2040,633,672,913671,11900,1324429,1124300
2041,595,588,913078,11905,1325017,1183100
2042,583,615,912462,11906,1325632,1115200
2043,604,612,911877,11879,1326244,1216300
2044,622,626,911246,11884,1326870,1093300
2045,593,593,910654,11883,1327463,1199900
2046,604,633,910067,11837,1328096,1159200
2047,596,568,909460,11876,1328664,1158700
2048,605,646,908871,11819,1329310,1104500
2049,562,590,908273,11827,1329900,1202200
2050,648,616,907662,11822,1330516,1158700
2051,634,670,907024,11790,1331186,1178400
2052,634,622,906387,11805,1331808,1329200
2053,592,607,905771,11814,1332415,1250500
2054,584,595,905189,11801,1333010,1272900
2055,593,609,904592,11789,1333619,1266600
2056,595,591,903994,11796,1334210,1140900
2057,561,655,903431,11704,1334865,1307300
2058,594,607,902857,11671,1335472,1327900
2059,626,635,902227,11666,1336107,1400600
2060,563,614,901656,11623,1336721,1446600
2061,533,586,901109,11584,1337307,1426200
2062,532,631,900580,11482,1337938,1698300
2063,607,595,900005,11462,1338533,1457700
2064,574,589,899415,11463,1339122,1660200
2065,619,554,898806,11518,1339676,1499100
2066,567,636,898244,11444,1340312,1514000
2067,586,624,897648,11416,1340936,1429100
2068,571,576,897056,11432,1341512,1420100
2069,584,574,896483,11431,1342086,1292400
2070,576,536,895930,11448,1342622,1291000
2071,578,562,895339,11477,1343184,1260300
2072,517,611,894807,11398,1343795,1284500
2073,539,570,894287,11348,1344365,1280100
2074,579,585,893694,11356,1344950,1286800
2075,541,591,893150,11309,1345541,1309400
2076,536,593,892618,11248,1346134,1370300
2077,567,590,892052,11224,1346724,1290500
2078,524,566,891526,11184,1347290,1285800
2079,547,579,890991,11140,1347869,1185400
2080,504,578,890474,11079,1348447,1211600
2081,606,570,889875,11108,1349017,1402000
2082,570,554,889333,11096,1349571,1181700
2083,568,559,888729,11141,1350130,1309400
2084,540,565,888184,11121,1350695,1228000
2085,571,611,887628,11066,1351306,1214800
2086,577,547,887048,11099,1351853,1236100
2087,570,570,886489,11088,1352423,1207700
2088,566,595,885902,11080,1353018,1261300
2089,560,574,885348,11060,1353592,1228400
2090,507,543,884822,11043,1354135,1113900
2091,560,579,884290,10996,1354714,1117300
2092,592,580,883694,11012,1355294,1171000
2093,500,579,883192,10935,1355873,1185900
2094,575,591,882623,10913,1356464,1245900
2095,511,572,882089,10875,1357036,1122900
2096,568,530,881529,10905,1357566,1167800
2097,559,551,880990,10893,1358117,1126700
2098,508,575,880468,10840,1358692,1111400
2099,509,583,879959,10766,1359275,1192700
2100,564,503,879394,10828,1359778,1487000
2101,548,559,878838,10825,1360337,1616000
2102,546,596,878294,10773,1360933,1286700
2103,584,537,877720,10810,1361470,1242700
2104,551,542,877167,10821,1362012,1180700
2105,567,569,876611,10808,1362581,1223800
2106,533,590,876068,10761,1363171,1172000
2107,477,596,875575,10658,1363767,1102200
2108,484,520,875093,10620,1364287,1247400
2109,567,562,874539,10612,1364849,1088300
2110,517,552,874005,10594,1365401,1032900
2111,546,566,873484,10549,1365967,1599400
2112,562,536,872922,10575,1366503,1372800
2113,557,555,872363,10579,1367058,1390700
2114,537,544,871817,10581,1367602,1125500
2115,516,574,871294,10530,1368176,1159500
2116,511,535,870796,10493,1368711,1263900
2117,542,587,870232,10470,1369298,1210800
2118,478,551,869764,10387,1369849,1122500
2119,547,529,869207,10415,1370378,1090100
2120,525,538,868716,10368,1370916,1173300
2121,577,605,868130,10349,1371521,1239000
2122,580,548,867551,10380,1372069,1119600
2123,555,535,866991,10405,1372604,1157100
2124,497,570,866484,10342,1373174,1193100
2125,494,558,865987,10281,1373732,1228300
2126,532,551,865463,10254,1374283,1125000
2127,502,505,864971,10241,1374788,1179600
2128,548,576,864411,10225,1375364,1277800
2129,531,541,863883,10212,1375905,1173100
2130,506,514,863363,10218,1376419,1226000
2131,584,511,862795,10275,1376930,1251700
2132,538,548,862271,10251,1377478,2346500
2133,510,521,861736,10265,1377999,1396300
2134,563,527,861167,10307,1378526,1407200
2135,565,563,860635,10276,1379089,1279400
2136,492,531,860109,10271,1379620,1316300
2137,517,567,859612,10201,1380187,1227100
2138,499,535,859092,10186,1380722,1201700
2139,567,488,858546,10244,1381210,1319000
2140,554,552,857992,10246,1381762,1416800
2141,558,509,857435,10294,1382271,1187500
2142,558,519,856887,10323,1382790,1191400
2143,546,509,856324,10377,1383299,1186800
2144,537,554,855781,10366,1383853,1216400
2145,542,534,855246,10367,1384387,1186600
2146,580,510,854673,10430,1384897,1129100
2147,559,526,854114,10463,1385423,1176400
2148,589,559,853539,10479,1385982,1113300
2149,543,525,852990,10503,1386507,1248100
2150,524,526,852457,10510,1387033,1056600
2151,512,548,851949,10470,1387581,1066600
2152,533,591,851400,10428,1388172,1237600
2153,539,539,850888,10401,1388711,1187600
2154,528,528,850329,10432,1389239,1118100
2155,550,547,849805,10409,1389786,1025400
2156,565,541,849227,10446,1390327,1031800
2157,580,497,848649,10527,1390824,1082500
2158,518,560,848136,10480,1391384,1201600
2159,520,582,847614,10420,1391966,1126600
2160,484,534,847133,10367,1392500,1149600
2161,576,510,846560,10430,1393010,1384700
2162,577,525,845975,10490,1393535,1248500
2163,526,528,845445,10492,1394063,1216700
2164,520,566,844923,10448,1394629,1260300
2165,616,554,844324,10493,1395183,1234200
2166,536,547,843786,10484,1395730,1266300
2167,545,540,843232,10498,1396270,1164400
2168,550,536,842688,10506,1396806,1132700
2169,555,549,842122,10523,1397355,1211600
2170,513,574,841612,10459,1397929,1155000
2171,548,534,841048,10489,1398463,1272100
2172,542,540,840535,10462,1399003,1176400
2173,527,545,840006,10446,1399548,1229300
2174,557,548,839437,10467,1400096,1254600
2175,572,541,838868,10495,1400637,1242100
2176,572,541,838295,10527,1401178,1174800
2177,561,542,837730,10550,1401720,1125600
2178,578,539,837166,10575,1402259,1139000
2179,594,527,836566,10648,1402786,1073100
2180,573,574,836000,10640,1403360,1107300
2181,607,572,835410,10658,1403932,1193500
2182,565,607,834818,10643,1404539,1279900
2183,588,539,834230,10692,1405078,1180400
2184,603,572,833634,10716,1405650,1224600
2185,577,529,833049,10772,1406179,1191400
2186,567,559,832478,10784,1406738,1205000
2187,574,568,831914,10780,1407306,1275400
2188,566,551,831348,10795,1407857,1374000
2189,616,566,830748,10829,1408423,1241100
2190,572,573,830176,10828,1408996,1207000
2191,608,555,829555,10894,1409551,1294900
2192,577,536,828978,10935,1410087,1104700
2193,620,550,828373,10990,1410637,1154300
2194,582,585,827785,10993,1411222,1263800
2195,533,524,827232,11022,1411746,1253500
2196,543,569,826683,11002,1412315,1300100
2197,573,591,826117,10977,1412906,1168400
2198,566,546,825552,10996,1413452,1202900
2199,525,569,825003,10976,1414021,1247100
2200,571,532,824468,10979,1414553,1182300
2201,541,588,823900,10959,1415141,1090500
2202,541,573,823377,10909,1415714,1161100
2203,621,596,822761,10929,1416310,1189400
2204,578,587,822172,10931,1416897,1265200
2205,578,574,821596,10933,1417471,1066700
2206,541,543,821064,10922,1418014,1123100
2207,599,572,820471,10943,1418586,1229400
2208,553,537,819894,10983,1419123,1266900
2209,535,591,819374,10912,1419714,1132900
2210,568,598,818809,10879,1420312,1204100
2211,582,581,818210,10897,1420893,1224500
2212,559,597,817670,10840,1421490,1143100
2213,525,528,817125,10857,1422018,1127400
2214,558,570,816595,10817,1422588,1144700
2215,560,564,816016,10832,1423152,1210900
2216,537,542,815465,10841,1423694,1153200
2217,555,557,814931,10818,1424251,1164600
2218,561,557,814356,10836,1424808,1192400
2219,569,568,813785,10839,1425376,1255300
2220,541,540,813256,10828,1425916,1308800
2221,535,565,812713,10806,1426481,1273900
2222,554,588,812168,10763,1427069,1380300
2223,527,497,811643,10791,1427566,1410000
2224,521,540,811118,10776,1428106,1309800
2225,536,561,810578,10755,1428667,1339600
2226,549,592,810025,10716,1429259,1249900
2227,545,569,809487,10685,1429828,1337900
2228,491,617,808991,10564,1430445,1236000
2229,549,552,808448,10555,1430997,1221000
2230,503,573,807942,10488,1431570,1248100
2231,511,556,807424,10450,1432126,1210400
2232,524,509,806894,10471,1432635,1239400
2233,511,549,806375,10441,1433184,1454900
2234,516,542,805867,10407,1433726,1400200
2235,528,550,805342,10382,1434276,1414900
2236,550,516,804811,10397,1434792,1270400
2237,528,523,804287,10398,1435315,1410700
2238,541,532,803735,10418,1435847,1597100
2239,536,531,803209,10413,1436378,1371400
2240,502,547,802688,10387,1436925,1347800
2241,550,547,802152,10376,1437472,1310000
2242,533,535,801593,10400,1438007,1178400
2243,530,530,801082,10381,1438537,1171900
2244,519,508,800553,10402,1439045,1180500
2245,505,522,800054,10379,1439567,1240900
2246,540,535,799506,10392,1440102,1172200
2247,558,538,798963,10397,1440640,1275300
2248,591,556,798398,10406,1441196,1118800
2249,543,547,797833,10424,1441743,1070300
2250,521,532,797302,10423,1442275,1368300
2251,562,559,796747,10419,1442834,1153400
2252,548,540,796197,10429,1443374,1148000
2253,514,515,795674,10437,1443889,1302400
2254,515,598,795148,10365,1444487,1161200
2255,500,513,794661,10339,1445000,1204700
2256,538,518,794138,10344,1445518,1166400
2257,548,573,793581,10328,1446091,1146200
2258,533,499,793040,10370,1446590,1236900
2259,571,517,792461,10432,1447107,1519500
2260,520,565,791959,10369,1447672,1325400
2261,541,530,791398,10400,1448202,1303900
2262,531,530,790887,10381,1448732,1304500
2263,540,519,790326,10423,1449251,1581600
2264,532,523,789800,10426,1449774,1635900
2265,529,544,789274,10408,1450318,1346900
2266,543,511,788748,10423,1450829,1316100
2267,572,539,788167,10465,1451368,1350000
2268,496,549,787666,10417,1451917,1486500
2269,568,534,787101,10448,1452451,1274000
2270,529,539,786576,10434,1452990,1182900
2271,607,531,785963,10516,1453521,1408700
2272,578,533,785391,10555,1454054,1568400
2273,496,534,784889,10523,1454588,1564700
2274,512,560,784390,10462,1455148,1297000
2275,552,564,783830,10458,1455712,1534500
2276,516,564,783308,10416,1456276,1395700
2277,511,552,782798,10374,1456828,1290800
2278,544,544,782262,10366,1457372,1266500
2279,518,565,781733,10330,1457937,1357600
2280,539,509,781181,10373,1458446,1339600
2281,549,555,780652,10347,1459001,1185700
2282,536,530,780110,10359,1459531,1263600
2283,536,537,779590,10342,1460068,1357800
2284,563,558,779016,10358,1460626,1598700
2285,562,583,778448,10343,1461209,1487200
2286,555,544,777907,10340,1461753,1675600
2287,557,558,777332,10357,1462311,1347300
2288,564,550,776779,10360,1462861,1302600
2289,554,542,776235,10362,1463403,1366700
2290,539,531,775700,10366,1463934,1238700
2291,534,525,775150,10391,1464459,1252900
2292,542,566,774616,10359,1465025,1301400
2293,549,513,774069,10393,1465538,1440300
2294,533,515,773517,10430,1466053,1599700
2295,542,564,772999,10384,1466617,1333300
2296,548,540,772441,10402,1467157,1284800
2297,513,550,771936,10357,1467707,1308200
2298,520,525,771412,10356,1468232,1305300
2299,539,518,770871,10379,1468750,1270600
2300,557,531,770319,10400,1469281,1256900
2301,548,531,769753,10435,1469812,1194500
2302,582,514,769191,10483,1470326,1137600
2303,585,524,768598,10552,1470850,1197500
2304,558,577,768049,10524,1471427,1264900
2305,536,590,767505,10478,1472017,1151400
2306,576,558,766951,10474,1472575,1228400
2307,542,563,766366,10496,1473138,1272600
2308,523,537,765844,10481,1473675,1270900
2309,540,558,765314,10453,1474233,1365300
2310,552,540,764762,10465,1474773,1352300
2311,560,542,764208,10477,1475315,1231300
2312,502,541,763692,10452,1475856,1385000
2313,474,514,763224,10406,1476370,1336600
2314,551,525,762677,10428,1476895,1334300
2315,530,546,762159,10400,1477441,1424600
2316,513,546,761637,10376,1477987,1468200
2317,527,509,761135,10369,1478496,1607700
2318,498,518,760602,10384,1479014,1668300
2319,533,559,760078,10349,1479573,1521100
2320,494,560,759579,10288,1480133,1309500
2321,532,524,759046,10297,1480657,1336900
2322,518,527,758533,10283,1481184,1307400
2323,516,567,758022,10227,1481751,1436300
2324,453,552,757540,10157,1482303,1493100
2325,548,556,757011,10130,1482859,1675200
2326,523,535,756493,10113,1483394,1545400
2327,521,531,755972,10103,1483925,1658400
2328,505,525,755460,10090,1484450,1363900
2329,514,534,754943,10073,1484984,1408400
2330,497,496,754449,10071,1485480,1468300
2331,523,499,753926,10095,1485979,1473800
2332,537,528,753406,10087,1486507,1455900
2333,516,526,752889,10078,1487033,1352900
2334,516,513,752376,10078,1487546,1234100
2335,495,493,751861,10100,1488039,1277700
2336,577,526,751283,10152,1488565,1357000
2337,570,523,750737,10175,1489088,1353600
2338,578,554,750160,10198,1489642,1140900
2339,539,587,749613,10158,1490229,1071400
2340,556,523,749064,10184,1490752,1278900
2341,516,518,748522,10208,1491270,1389200
2342,552,532,747994,10204,1491802,1285400
2343,486,503,747493,10202,1492305,1158300
2344,477,525,747016,10154,1492830,1138500
2345,516,522,746515,10133,1493352,1170300
2346,524,485,745969,10194,1493837,1199000
2347,510,490,745470,10203,1494327,1161300
2348,533,469,744940,10264,1494796,1155300
2349,536,549,744387,10268,1495345,1119700
2350,505,525,743885,10245,1495870,1072900
2351,529,543,743369,10218,1496413,1137000
2352,521,570,742843,10174,1496983,1119500
2353,508,498,742328,10191,1497481,1116400
2354,538,515,741805,10199,1497996,1195600
2355,555,501,741262,10241,1498497,1250000
2356,481,520,740768,10215,1499017,1131600
2357,511,565,740248,10170,1499582,1044900
2358,519,518,739723,10177,1500100,1048700
2359,483,526,739236,10138,1500626,1054600
2360,512,496,738728,10150,1501122,1087600
2361,496,523,738247,10108,1501645,1129200
2362,530,516,737717,10122,1502161,1152700
2363,514,563,737192,10084,1502724,1152800
2364,513,537,736683,10056,1503261,1105600
2365,491,541,736190,10008,1503802,1112500
2366,499,538,735680,9980,1504340,1149000
2367,531,523,735156,9981,1504863,1174800
2368,487,534,734656,9947,1505397,1050900
2369,475,516,734182,9905,1505913,1268000
2370,521,540,733687,9860,1506453,1103600
2371,513,508,733156,9883,1506961,1083000
2372,513,483,732664,9892,1507444,1080000
2373,504,513,732154,9889,1507957,1070600
2374,533,513,731618,9912,1508470,1211100
2375,531,542,731104,9884,1509012,1159600
2376,508,540,730581,9867,1509552,1071100
2377,509,480,730063,9905,1510032,1082400
2378,493,502,729562,9904,1510534,1150800
2379,476,529,729101,9836,1511063,1161000
2380,537,511,728582,9844,1511574,1149800
2381,503,472,728075,9879,1512046,1109100
2382,499,496,727560,9898,1512542,1151700
2383,496,538,727058,9862,1513080,1135300
2384,515,505,726550,9865,1513585,1105600
2385,498,499,726041,9875,1514084,1245300
2386,498,522,725534,9860,1514606,1249400
2387,494,518,725057,9819,1515124,1177200
2388,476,492,724587,9797,1515616,1144400
2389,510,486,724072,9826,1516102,1140600
2390,540,483,723518,9897,1516585,1195200
2391,510,530,723018,9867,1517115,1151200
2392,549,518,722493,9874,1517633,1178200
2393,510,517,721971,9879,1518150,1225100
2394,499,522,721466,9862,1518672,1410600
2395,509,550,720978,9800,1519222,1302900
2396,515,525,720450,9803,1519747,1151400
2397,525,503,719921,9829,1520250,1248200
2398,501,528,719408,9814,1520778,1124000
2399,567,514,718845,9863,1521292,1033200
2400,518,467,718325,9916,1521759,1079700
2401,493,531,717821,9889,1522290,1066800
2402,499,491,717338,9881,1522781,1039100
2403,529,496,716800,9923,1523277,1136600
2404,494,512,716316,9895,1523789,1047700
2405,536,504,715778,9929,1524293,1084400
2406,513,498,715268,9941,1524791,1101100
2407,518,565,714744,9900,1525356,1079900
2408,523,482,714233,9929,1525838,1055500
2409,535,506,713709,9947,1526344,1117000
2410,482,518,713198,9940,1526862,1112600
2411,530,491,712673,9974,1527353,1232200
2412,508,515,712159,9973,1527868,1074300
2413,571,501,711618,10013,1528369,1059500
2414,529,559,711071,10001,1528928,1093400
2415,519,538,710552,9982,1529466,1117100
2416,531,526,710023,9985,1529992,1090200
2417,487,518,709520,9970,1530510,1122100
2418,508,479,709025,9986,1530989,1441700
2419,492,492,708531,9988,1531481,1087300
2420,501,532,708023,9964,1532013,1267500
2421,528,517,707508,9962,1532530,1082900
2422,478,506,707032,9932,1533036,1121500
2423,518,491,706517,9956,1533527,1157500
2424,466,519,706033,9921,1534046,1051800
2425,477,489,705547,9918,1534535,1052500
2426,501,497,705053,9915,1535032,1027300
2427,499,507,704572,9889,1535539,1038200
2428,510,511,704048,9902,1536050,1007000
2429,491,488,703550,9912,1536538,1041900
2430,546,501,703023,9938,1537039,992400
2431,477,513,702521,9927,1537552,1029400
2432,500,497,702043,9908,1538049,1030700
2433,496,494,701544,9913,1538543,1102200
2434,549,504,701002,9951,1539047,1060500
2435,500,530,700496,9927,1539577,1043700
2436,464,549,700010,9864,1540126,1101500
2437,517,519,699520,9835,1540645,1076800
2438,511,512,699006,9837,1541157,1016700
2439,526,516,698506,9821,1541673,1081300
2440,497,457,697980,9890,1542130,1036700
2441,518,520,697475,9875,1542650,1065500
2442,499,538,696973,9839,1543188,1067700
2443,484,523,696485,9804,1543711,994600
2444,485,530,695984,9775,1544241,1023500
2445,481,481,695489,9789,1544722,1019900
2446,503,515,695022,9741,1545237,1022100
2447,464,471,694535,9757,1545708,1021500
2448,481,531,694057,9704,1546239,1008000
2449,466,464,693583,9714,1546703,1077400
2450,474,502,693115,9680,1547205,1080700
2451,500,514,692640,9641,1547719,1019700
2452,452,505,692161,9615,1548224,1198100
2453,463,510,691710,9556,1548734,1105000
2454,433,486,691259,9521,1549220,1060700
2455,459,480,690823,9477,1549700,1056200
2456,427,475,690373,9452,1550175,1160700
2457,421,481,689947,9397,1550656,1293900
2458,419,500,689530,9314,1551156,1152300
2459,449,457,689090,9297,1551613,1080300
2460,452,477,688634,9276,1552090,1105500
2461,404,491,688224,9195,1552581,1158300
2462,476,489,687770,9160,1553070,1087800
2463,476,477,687276,9177,1553547,1035700
2464,480,487,686810,9156,1554034,1081500
2465,461,488,686340,9138,1554522,1077200
2466,514,461,685834,9183,1554983,1055900
2467,487,465,685344,9208,1555448,1139100
2468,475,467,684874,9211,1555915,1129000
2469,484,476,684387,9222,1556391,1086100
2470,442,487,683922,9200,1556878,1097600
2471,490,502,683463,9157,1557380,1057900
2472,461,440,682978,9202,1557820,1131300
2473,467,488,682532,9160,1558308,1073600
2474,486,448,682039,9205,1558756,1091600
2475,429,482,681604,9158,1559238,1158500
2476,484,484,681136,9142,1559722,1123400
2477,468,485,680665,9128,1560207,1032800
2478,454,481,680194,9118,1560688,1057800
2479,469,458,679738,9116,1561146,1108400
2480,494,451,679255,9148,1561597,1095100
2481,464,459,678781,9163,1562056,1195000
2482,443,483,678321,9140,1562539,1272900
2483,459,481,677884,9096,1563020,1297600
2484,433,434,677423,9123,1563454,1241100
2485,470,513,676970,9063,1563967,1114700
2486,454,398,676518,9117,1564365,1177200
2487,461,436,676055,9144,1564801,1311000
2488,455,465,675596,9138,1565266,1208900
2489,470,475,675125,9134,1565741,1195900
2490,476,477,674660,9122,1566218,1283800
2491,477,458,674189,9135,1566676,1168300
2492,479,474,673699,9151,1567150,1218400
2493,455,458,673235,9157,1567608,1397000
2494,484,483,672769,9140,1568091,1224700
2495,470,480,672270,9159,1568571,1249600
2496,450,460,671827,9142,1569031,1281900
2497,437,518,671404,9047,1569549,1199200
2498,506,466,670897,9088,1570015,1137400
2499,473,511,670423,9051,1570526,1139200
2500,449,487,669975,9012,1571013,1156600
2501,438,449,669526,9012,1571462,1082500
2502,444,456,669090,8992,1571918,1082500
2503,451,480,668640,8962,1572398,1088300
2504,419,478,668215,8909,1572876,1089800
2505,420,483,667786,8855,1573359,1182500
2506,400,441,667389,8811,1573800,1157000
2507,447,441,666956,8803,1574241,1116900
2508,416,433,666532,8794,1574674,1117600
2509,436,436,666102,8788,1575110,1077100
2510,450,469,665650,8771,1575579,1168300
2511,452,461,665181,8779,1576040,1171600
2512,423,466,664759,8735,1576506,1191600
2513,443,423,664346,8725,1576929,1181900
2514,449,459,663876,8736,1577388,1328500
2515,466,451,663428,8733,1577839,1265100
2516,408,425,662994,8742,1578264,1138900
2517,481,479,662529,8728,1578743,1038700
2518,440,450,662065,8742,1579193,1027000
2519,454,464,661620,8723,1579657,1265400
2520,401,451,661228,8664,1580108,1175700
2521,406,447,660823,8622,1580555,1083500
2522,460,469,660361,8615,1581024,1082400
2523,432,442,659923,8611,1581466,1154100
2524,420,452,659509,8573,1581918,1036200
2525,435,448,659088,8546,1582366,1069500
2526,404,476,658655,8503,1582842,1167300
2527,400,464,658275,8419,1583306,1098800
2528,407,416,657870,8408,1583722,1080200
2529,435,432,657419,8427,1584154,1148900
2530,463,393,656972,8481,1584547,1089600
2531,436,432,656547,8474,1584979,1070000
2532,428,428,656094,8499,1585407,1015400
2533,418,443,655680,8470,1585850,1107600
2534,453,450,655228,8472,1586300,1207100
2535,468,431,654772,8497,1586731,1225300
2536,464,456,654301,8512,1587187,1209700
2537,437,405,653855,8553,1587592,1213800
2538,409,447,653448,8513,1588039,1212000
2539,449,429,653000,8532,1588468,1104800
2540,442,455,652559,8518,1588923,1063000
2541,478,430,652090,8557,1589353,1085700
2542,449,436,651635,8576,1589789,1108900
2543,430,458,651217,8536,1590247,1020400
2544,455,419,650765,8569,1590666,1095000
2545,452,462,650301,8571,1591128,1057700
2546,434,432,649854,8586,1591560,1072200
2547,432,459,649453,8528,1592019,1123400
2548,441,413,648991,8577,1592432,1148500
2549,441,440,648559,8569,1592872,1073500
2550,415,435,648121,8572,1593307,1073500
2551,506,462,647647,8584,1593769,1048100
2552,466,394,647181,8656,1594163,1136600
2553,451,423,646726,8688,1594586,1114500
2554,402,425,646309,8680,1595011,1115900
2555,421,417,645884,8688,1595428,1118800
2556,444,458,645452,8662,1595886,1111700
2557,449,445,644995,8674,1596331,1122400
2558,451,443,644554,8672,1596774,1160400
2559,441,419,644118,8689,1597193,1157600
2560,487,456,643643,8708,1597649,1123700
2561,462,423,643162,8766,1598072,1176200
2562,454,462,642700,8766,1598534,1115500
2563,452,457,642262,8747,1598991,1068300
2564,436,459,641811,8739,1599450,1055900
2565,455,482,641359,8709,1599932,1395900
2566,441,493,640917,8658,1600425,1194400
2567,408,416,640498,8661,1600841,1254300
2568,435,470,640068,8621,1601311,1150100
2569,459,419,639638,8632,1601730,1119300
2570,499,442,639131,8697,1602172,1309500
2571,439,448,638676,8704,1602620,1113500
2572,464,414,638225,8741,1603034,1186600
2573,429,476,637779,8711,1603510,1153100
2574,480,470,637318,8702,1603980,1218800
2575,453,441,636857,8722,1604421,1148900
2576,472,459,636403,8717,1604880,1102400
2577,469,387,635932,8801,1605267,1125800
2578,485,472,635455,8806,1605739,1114700
2579,479,462,634967,8832,1606201,1069600
2580,447,432,634497,8870,1606633,1041400
2581,440,431,634064,8872,1607064,1104500
2582,487,457,633586,8893,1607521,1109200
2583,465,510,633131,8838,1608031,1095100
2584,438,484,632674,8811,1608515,1128500
2585,465,458,632208,8819,1608973,1036800
2586,475,468,631729,8830,1609441,1190900
2587,457,498,631267,8794,1609939,1207300
2588,492,445,630797,8819,1610384,1225700
2589,457,457,630328,8831,1610841,1263400
2590,478,468,629845,8846,1611309,1173300
2591,491,498,629358,8835,1611807,1333200
2592,461,459,628906,8828,1612266,1157000
2593,453,475,628454,8805,1612741,1144200
2594,442,465,627998,8796,1613206,1092800
2595,447,475,627550,8769,1613681,1023100
2596,457,433,627097,8789,1614114,1064700
2597,420,467,626669,8750,1614581,1068900
2598,423,464,626258,8697,1615045,1054600
2599,467,406,625784,8765,1615451,1103400
2600,380,443,625386,8720,1615894,1053100
2601,431,441,624972,8693,1616335,1025700
2602,405,488,624574,8603,1616823,1050300
2603,469,472,624108,8597,1617295,1149800
2604,404,452,623673,8580,1617747,1196900
2605,407,443,623291,8519,1618190,1178900
2606,423,424,622853,8533,1618614,1200100
2607,458,419,622412,8555,1619033,1160200
2608,434,458,621973,8536,1619491,1073800
2609,453,444,621530,8535,1619935,1118300
2610,392,438,621120,8507,1620373,1051400
2611,432,433,620708,8486,1620806,1051800
2612,415,428,620272,8494,1621234,1111500
2613,427,463,619857,8446,1621697,1232300
2614,397,407,619463,8433,1622104,1170700
2615,382,398,619078,8420,1622502,1119500
2616,419,431,618648,8419,1622933,1048000
2617,422,470,618231,8366,1623403,1048300
2618,397,434,617830,8333,1623837,1097800
2619,408,439,617432,8292,1624276,1091800
2620,407,404,617020,8300,1624680,1148600
2621,423,409,616590,8321,1625089,1099800
2622,403,451,616186,8274,1625540,1249500
2623,402,438,615787,8235,1625978,1102700
2624,404,411,615382,8229,1626389,1139000
2625,397,411,614993,8207,1626800,1141500
2626,413,415,614572,8213,1627215,1375000
2627,388,390,614181,8214,1627605,1250600
2628,435,439,613757,8199,1628044,1242600
2629,436,451,613331,8174,1628495,1154100
2630,427,413,612885,8207,1628908,1290400
2631,416,406,612475,8211,1629314,1109900
2632,414,436,612055,8195,1629750,1146000
2633,451,405,611627,8218,1630155,1050400
2634,387,436,611209,8200,1630591,1155600
2635,448,420,610773,8216,1631011,1062500
2636,431,442,610364,8183,1631453,1092100
2637,430,433,609925,8189,1631886,1305300
2638,401,448,609523,8143,1632334,1107400
2639,426,453,609086,8127,1632787,1175000
2640,450,395,608637,8181,1633182,1188700
2641,402,387,608233,8198,1633569,1077300
2642,389,463,607862,8106,1634032,1163200
2643,396,398,607446,8124,1634430,1236500
2644,420,432,607028,8110,1634862,1102800
2645,398,388,606631,8119,1635250,1181500
2646,445,418,606185,8147,1635668,1092800
2647,454,407,605730,8195,1636075,1095100
2648,424,432,605321,8172,1636507,1074300
2649,457,460,604864,8169,1636967,1142900
2650,446,437,604409,8187,1637404,1083400
2651,427,433,603974,8189,1637837,1202500
2652,428,447,603566,8150,1638284,1109400
2653,431,433,603112,8171,1638717,1076100
2654,407,437,602707,8139,1639154,1060900
2655,427,425,602286,8135,1639579,1179500
2656,417,424,601885,8112,1640003,1139300
2657,418,407,601447,8143,1640410,1137400
2658,362,468,601069,8053,1640878,1130500
2659,425,409,600666,8047,1641287,1200500
2660,449,404,600232,8077,1641691,1167000
2661,412,428,599806,8075,1642119,1052400
2662,440,387,599375,8119,1642506,1089000
2663,412,454,598943,8097,1642960,1094200
2664,437,408,598514,8118,1643368,1102400
2665,437,428,598076,8128,1643796,1072500
2666,409,433,597679,8092,1644229,1043200
2667,427,426,597221,8124,1644655,1335100
2668,393,410,596835,8100,1645065,1135000
2669,407,410,596435,8090,1645475,1122000
2670,420,410,596029,8086,1645885,1172800
2671,353,428,595660,8027,1646313,1108900
2672,418,424,595252,8011,1646737,1044800
2673,408,385,594829,8049,1647122,1081600
2674,392,389,594435,8054,1647511,1044800
2675,437,454,594017,8018,1647965,1151700
2676,377,396,593627,8012,1648361,1102400
2677,398,434,593221,7984,1648795,1127300
2678,408,389,592824,7992,1649184,1073000
2679,390,420,592437,7959,1649604,1048400
2680,387,416,592048,7932,1650020,1338800
2681,396,410,591666,7904,1650430,1216900
2682,411,392,591245,7933,1650822,1371700
2683,400,417,590838,7923,1651239,1408900
2684,430,410,590417,7934,1651649,1509300
2685,392,466,590006,7879,1652115,1360000
2686,406,425,589617,7843,1652540,1485500
2687,417,404,589190,7866,1652944,1454000
2688,414,407,588785,7864,1653351,1370900
2689,425,410,588363,7876,1653761,1145500
2690,359,394,587993,7852,1654155,1646100
2691,385,374,587616,7855,1654529,1264800
2692,419,415,587194,7862,1654944,1190700
2693,373,376,586817,7863,1655320,1194500
2694,413,407,586391,7882,1655727,1371400
2695,399,447,586024,7802,1656174,1257100
2696,425,405,585592,7829,1656579,1646800
2697,419,434,585175,7812,1657013,1255400
2698,426,383,584749,7855,1657396,1259700
2699,428,376,584315,7913,1657772,1163000
2700,426,409,583884,7935,1658181,1162200
2701,417,416,583479,7924,1658597,1129600
2702,435,410,583044,7949,1659007,1095400
2703,408,392,582628,7973,1659399,1046700
2704,440,421,582195,7985,1659820,1160200
2705,424,432,581768,7980,1660252,1265600
2706,415,429,581346,7973,1660681,1191600
2707,406,403,580946,7970,1661084,1282700
2708,378,414,580547,7955,1661498,1169100
2709,415,394,580148,7960,1661892,1171700
2710,422,441,579737,7930,1662333,1236500
2711,440,411,579287,7969,1662744,1199800
2712,455,412,578831,8013,1663156,1226800
2713,419,460,578420,7964,1663616,1135700
2714,409,426,577990,7968,1664042,1147900
2715,434,406,577573,7979,1664448,1104400
2716,404,433,577169,7950,1664881,1057300
2717,406,393,576760,7966,1665274,1139900
2718,423,426,576339,7961,1665700,1091100
2719,411,417,575942,7941,1666117,1082300
2720,386,432,575536,7915,1666549,1155100
2721,406,423,575132,7896,1666972,1162400
2722,433,400,574707,7921,1667372,1065400
2723,410,393,574297,7938,1667765,1166600
2724,414,433,573893,7909,1668198,1112800
2725,414,409,573460,7933,1668607,1232500
2726,401,352,573064,7977,1668959,1190200
2727,410,403,572653,7985,1669362,1114500
2728,414,461,572232,7945,1669823,1197300
2729,429,410,571814,7953,1670233,1312900
2730,418,404,571380,7983,1670637,1395200
2731,404,423,570991,7949,1671060,1359600
2732,397,428,570587,7925,1671488,1214000
2733,402,380,570181,7951,1671868,1558300
2734,387,393,569803,7936,1672261,1377300
2735,416,406,569398,7935,1672667,1319400
2736,378,410,569016,7907,1673077,1281100
2737,407,446,568603,7874,1673523,1247400
2738,415,395,568173,7909,1673918,1272700
2739,426,428,567750,7904,1674346,1161100
2740,424,410,567334,7910,1674756,1360600
2741,423,388,566917,7939,1675144,1597400
2742,418,414,566495,7947,1675558,1630100
2743,389,422,566101,7919,1675980,1396900
2744,402,397,565698,7925,1676377,1397100
2745,395,415,565300,7908,1676792,1301000
2746,401,382,564900,7926,1677174,1320700
2747,393,416,564515,7895,1677590,1237200
2748,413,423,564098,7889,1678013,1330000
2749,405,420,563700,7867,1678433,1220600
2750,397,412,563314,7841,1678845,1217400
2751,400,451,562891,7813,1679296,1191500
2752,360,384,562520,7800,1679680,1104100
2753,390,410,562131,7779,1680090,1076400
2754,411,399,561730,7781,1680489,1178200
2755,392,365,561338,7808,1680854,1212800
2756,382,387,560957,7802,1681241,1200400
2757,410,405,560540,7814,1681646,1200100
2758,391,408,560174,7772,1682054,1217700
2759,410,413,559748,7785,1682467,1152500
2760,393,435,559357,7741,1682902,1096200
2761,371,389,558976,7733,1683291,1077200
2762,375,364,558621,7724,1683655,1214500
2763,415,382,558182,7781,1684037,1116000
2764,414,385,557781,7797,1684422,1044600
2765,351,397,557428,7753,1684819,1244100
2766,396,400,557040,7741,1685219,1165500
2767,394,382,556645,7754,1685601,1038700
2768,377,417,556266,7716,1686018,1093400
2769,390,429,555873,7680,1686447,1066200
2770,409,367,555453,7733,1686814,1115400
2771,395,393,555074,7719,1687207,1124100
2772,413,422,554664,7707,1687629,1040400
2773,407,411,554249,7711,1688040,1065700
2774,417,368,553834,7758,1688408,1199300
2775,381,375,553450,7767,1688783,1175900
2776,391,401,553082,7734,1689184,1047700
2777,410,363,552644,7809,1689547,1063600
2778,405,378,552235,7840,1689925,1112800
2779,427,397,551814,7864,1690322,1035500
2780,395,425,551425,7828,1690747,1031500
2781,407,437,551018,7798,1691184,1089600
2782,371,383,550632,7801,1691567,1049800
2783,410,427,550231,7775,1691994,1057100
2784,387,421,549848,7737,1692415,1112300
2785,411,375,549435,7775,1692790,1070800
2786,412,431,549016,7763,1693221,1111400
2787,393,401,548624,7754,1693622,1106300
2788,452,435,548186,7757,1694057,1007900
2789,385,377,547790,7776,1694434,1107200
2790,429,387,547376,7803,1694821,1365100
2791,409,438,546967,7774,1695259,1182700
2792,417,370,546546,7825,1695629,1621900
2793,435,396,546119,7856,1696025,1351800
2794,424,406,545708,7861,1696431,1224500
2795,422,420,545265,7884,1696851,1138700
2796,422,399,544840,7910,1697250,1104100
2797,384,385,544457,7908,1697635,1166900
2798,428,384,544024,7957,1698019,1081400
2799,384,407,543637,7937,1698426,1213800
2800,391,430,543242,7902,1698856,1296300
2801,428,403,542823,7918,1699259,1157200
2802,392,407,542425,7909,1699666,1126400
2803,386,444,542047,7843,1700110,1047800
2804,415,403,541652,7835,1700513,1078300
2805,370,411,541258,7818,1700924,1096100
2806,390,378,540878,7820,1701302,1092900
2807,384,422,540483,7793,1701724,1080600
2808,373,402,540116,7758,1702126,1039200
2809,345,385,539759,7730,1702511,1063900
2810,362,423,539390,7676,1702934,1222100
2811,374,383,539014,7669,1703317,1180400
2812,376,376,538655,7652,1703693,1196200
2813,395,410,538250,7647,1704103,1213200
2814,400,369,537849,7679,1704472,1201000
2815,370,404,537482,7642,1704876,1122000
2816,399,389,537089,7646,1705265,1067800
2817,379,427,536705,7603,1705692,1133600
2818,349,397,536345,7566,1706089,1148300
2819,379,395,535980,7536,1706484,1160900
2820,408,357,535566,7593,1706841,1159600
2821,382,365,535181,7613,1707206,1266600
2822,345,444,534856,7494,1707650,1167600
2823,398,389,534451,7510,1708039,1062300
2824,385,382,534073,7506,1708421,1097500
2825,353,410,533703,7466,1708831,1122200
2826,383,381,533327,7461,1709212,1097000
2827,395,351,532942,7495,1709563,1035300
2828,380,386,532540,7511,1709949,1118500
2829,356,398,532204,7449,1710347,1078500
2830,398,403,531810,7440,1710750,1259600
2831,389,382,531396,7472,1711132,1147500
2832,333,371,531074,7423,1711503,1140600
2833,359,371,530718,7408,1711874,1117300
2834,402,393,530307,7426,1712267,1402500
2835,378,377,529932,7424,1712644,1164400
2836,361,389,529567,7400,1713033,1064800
2837,383,361,529199,7407,1713394,1145600
2838,399,396,528808,7402,1713790,1132100
2839,361,400,528454,7356,1714190,1104600
2840,395,396,528040,7374,1714586,1116000
2841,418,368,527612,7434,1714954,1034200
2842,386,391,527248,7407,1715345,1081400
2843,401,410,526844,7401,1715755,1147200
2844,406,402,526433,7410,1716157,1142800
2845,408,358,526038,7447,1716515,1064000
2846,368,406,525635,7444,1716921,1155800
2847,377,358,525272,7449,1717279,1232300
2848,379,381,524875,7465,1717660,1119300
2849,386,388,524507,7445,1718048,1184100
2850,402,383,524125,7444,1718431,1187600
2851,409,385,523686,7498,1718816,1175100
2852,417,388,523296,7500,1719204,1220800
2853,387,430,522907,7459,1719634,1270500
2854,409,372,522485,7509,1720006,1242100
2855,399,394,522083,7517,1720400,1236700
2856,350,365,521732,7503,1720765,1304600
2857,418,368,521333,7534,1721133,1058700
2858,389,379,520920,7568,1721512,1242400
2859,377,379,520546,7563,1721891,1177600
2860,365,391,520193,7525,1722282,1125500
2861,351,382,519836,7500,1722664,1136900
2862,401,383,519446,7507,1723047,1062800
2863,393,410,519033,7510,1723457,1093000
2864,392,388,518661,7494,1723845,1026400
2865,381,394,518269,7492,1724239,1099300
2866,378,394,517883,7484,1724633,1091300
2867,345,409,517540,7418,1725042,1229600
2868,374,388,517178,7392,1725430,1085600
2869,384,405,516789,7376,1725835,1103600
2870,379,375,516402,7388,1726210,1030800
2871,385,392,516032,7366,1726602,1014100
2872,342,381,515682,7335,1726983,1157600
2873,379,334,515303,7380,1727317,1164900
2874,409,404,514899,7380,1727721,1054200
2875,353,370,514538,7371,1728091,1102100
2876,379,356,514163,7390,1728447,1091200
2877,371,388,513790,7375,1728835,1080800
2878,380,391,513408,7366,1729226,1111900
2879,411,361,513001,7412,1729587,1092400
2880,390,351,512608,7454,1729938,1079100
2881,379,375,512236,7451,1730313,1116400
2882,394,384,511829,7474,1730697,1331100
2883,376,383,511476,7444,1731080,1206900
2884,348,411,511111,7398,1731491,1324800
2885,367,387,510736,7386,1731878,1292200
2886,396,401,510354,7367,1732279,1356200
2887,377,395,509959,7367,1732674,1140000
2888,368,370,509608,7348,1733044,1107800
2889,382,354,509247,7355,1733398,1222900
2890,350,378,508871,7353,1733776,1139100
2891,346,396,508526,7302,1734172,1109300
2892,399,375,508136,7317,1734547,1110300
2893,378,345,507748,7360,1734892,1072300
2894,400,451,507355,7302,1735343,1199800
2895,380,358,506970,7329,1735701,1222900
2896,371,388,506599,7312,1736089,1212600
2897,388,378,506211,7322,1736467,1281100
2898,396,355,505809,7369,1736822,1499900
2899,401,340,505424,7414,1737162,1275800
2900,378,356,505033,7449,1737518,1218900
2901,369,404,504650,7428,1737922,1266200
2902,393,375,504258,7445,1738297,1292900
2903,391,399,503886,7418,1738696,1602900
2904,367,364,503512,7428,1739060,1401000
2905,355,408,503148,7384,1739468,1324400
2906,357,417,502804,7311,1739885,1193000
2907,367,388,502426,7301,1740273,1213700
2908,352,383,502097,7247,1740656,1186300
2909,370,367,501704,7273,1741023,1268100
2910,390,382,501338,7257,1741405,1372100
2911,386,380,500936,7279,1741785,1262600
2912,344,366,500580,7269,1742151,1294300
2913,346,364,500237,7248,1742515,1179400
2914,392,407,499863,7215,1742922,1152600
2915,340,359,499510,7209,1743281,1250200
2916,365,379,499147,7193,1743660,1317100
2917,326,373,498817,7150,1744033,1188500
2918,348,398,498474,7095,1744431,1185400
2919,367,354,498116,7099,1744785,1232000
2920,324,345,497776,7094,1745130,1164600
2921,389,356,497393,7121,1745486,1145400
2922,357,370,497029,7115,1745856,1227400
2923,367,379,496664,7101,1746235,1187800
2924,363,367,496312,7086,1746602,1170800
2925,336,369,495960,7069,1746971,1183500
2926,352,394,495629,7006,1747365,1139900
2927,383,415,495242,6978,1747780,1286400
2928,306,308,494926,6986,1748088,1282500
2929,351,389,494589,6934,1748477,1259200
2930,354,385,494220,6918,1748862,1155500
2931,331,370,493896,6872,1749232,1144600
2932,329,350,493569,6849,1749582,1094000
2933,320,348,493233,6837,1749930,1107900
2934,348,314,492889,6867,1750244,1111100
2935,363,329,492531,6896,1750573,1110900
2936,320,322,492203,6902,1750895,1134500
2937,355,352,491870,6883,1751247,1057300
2938,356,339,491508,6906,1751586,1203000
2939,351,346,491148,6920,1751932,1165000
2940,322,349,490815,6904,1752281,1130600
2941,349,332,490483,6904,1752613,1057500
2942,344,379,490134,6874,1752992,1155100
2943,412,366,489726,6916,1753358,1150200
2944,374,376,489356,6910,1753734,1151600
2945,314,396,489028,6842,1754130,1171800
2946,380,336,488665,6869,1754466,1215500
2947,373,326,488282,6926,1754792,1129300
2948,352,333,487931,6944,1755125,1124600
2949,373,342,487556,6977,1755467,1070900
2950,364,368,487208,6957,1755835,1104300
2951,339,343,486854,6968,1756178,1297000
2952,368,368,486497,6957,1756546,1132800
2953,366,344,486124,6986,1756890,1166500
2954,339,336,485780,6994,1757226,1063700
2955,323,396,485455,6923,1757622,1091100
2956,335,392,485129,6857,1758014,1075400
2957,335,362,484793,6831,1758376,1097100
2958,331,374,484456,6794,1758750,1134800
2959,347,350,484103,6797,1759100,1091400
2960,317,384,483783,6733,1759484,1038900
2961,332,351,483462,6703,1759835,1207000
2962,341,350,483112,6703,1760185,1118000
2963,358,376,482765,6674,1760561,1193700
2964,349,359,482405,6675,1760920,1112800
2965,325,371,482083,6626,1761291,1175700
2966,359,372,481735,6602,1761663,1233900
2967,311,312,481413,6612,1761975,1222500
2968,312,336,481109,6580,1762311,1188500
2969,348,365,480756,6568,1762676,1182000
2970,365,340,480390,6594,1763016,1148700
2971,340,324,480050,6610,1763340,1221500
2972,370,358,479685,6617,1763698,1211800
2973,385,350,479313,6639,1764048,1119100
2974,351,345,478950,6657,1764393,1036500
2975,329,360,478615,6632,1764753,1065300
2976,348,336,478268,6643,1765089,1053000
2977,381,338,477888,6685,1765427,1245700
2978,339,338,477545,6690,1765765,1090400
2979,362,336,477179,6720,1766101,1365400
2980,387,323,476811,6765,1766424,1099800
2981,360,364,476443,6769,1766788,1158400
2982,370,354,476080,6778,1767142,1052100
2983,362,372,475707,6779,1767514,1093300
2984,376,351,475342,6793,1767865,1058900
2985,378,356,474940,6839,1768221,1114500
2986,391,361,474575,6843,1768582,1177300
2987,340,339,474224,6855,1768921,1106500
2988,354,357,473876,6846,1769278,1209800
2989,357,355,473503,6864,1769633,1081000
2990,360,338,473148,6881,1769971,1122200
2991,409,347,472759,6923,1770318,1061100
2992,345,385,472393,6904,1770703,1059800
2993,317,343,472075,6879,1771046,1008300
2994,345,368,471725,6861,1771414,1099500
2995,335,335,471406,6845,1771749,1092400
2996,374,362,471037,6852,1772111,1077700
2997,368,365,470662,6862,1772476,1101600
2998,342,334,470325,6865,1772810,1040600
2999,317,353,469996,6841,1773163,1108500
3000,329,340,469662,6835,1773503,1235900
3001,339,351,469319,6827,1773854,1119700
3002,324,353,469014,6779,1774207,1216100
3003,335,372,468668,6753,1774579,1203000
3004,368,365,468323,6733,1774944,1122000
3005,334,332,467973,6751,1775276,1094800
3006,352,359,467615,6750,1775635,1065200
3007,308,343,467297,6725,1775978,1070700
3008,348,369,466968,6685,1776347,1024400
3009,336,353,466615,6685,1776700,1086000
3010,396,349,466240,6711,1777049,1087200
3011,347,334,465882,6735,1777383,1043900
3012,331,338,465561,6718,1777721,1053600
3013,305,367,465241,6671,1778088,1038800
3014,332,326,464918,6668,1778414,1061000
3015,313,370,464601,6615,1778784,1063000
3016,365,379,464239,6598,1779163,1023400
3017,331,324,463907,6606,1779487,1053400
3018,362,341,463542,6630,1779828,1088300
3019,351,331,463188,6653,1780159,1082500
3020,335,386,462846,6609,1780545,1081500
3021,369,327,462483,6645,1780872,1268000
3022,347,317,462124,6687,1781189,1263400
3023,358,351,461790,6670,1781540,1197300
3024,383,325,461407,6728,1781865,1129800
3025,357,382,461036,6717,1782247,1242200
3026,335,345,460714,6694,1782592,1316200
3027,334,338,460382,6688,1782930,1218200
3028,335,324,460034,6712,1783254,1274500
3029,328,361,459710,6675,1783615,1203800
3030,353,356,459370,6659,1783971,1225200
3031,324,380,459022,6627,1784351,1209500
3032,352,341,458700,6608,1784692,1075600
3033,349,332,458328,6648,1785024,1088600
3034,304,349,458004,6623,1785373,1047800
3035,361,347,457666,6614,1785720,1141700
3036,306,349,457355,6576,1786069,1141900
3037,347,313,457020,6598,1786382,1089800
3038,359,319,456660,6639,1786701,1073300
3039,362,361,456303,6635,1787062,1046700
3040,346,355,455947,6636,1787417,1128700
3041,347,341,455592,6650,1787758,1100700
3042,333,345,455273,6624,1788103,1097200
3043,352,323,454913,6661,1788426,1158800
3044,342,367,454561,6646,1788793,1076800
3045,391,346,454211,6650,1789139,1099800
3046,339,370,453852,6639,1789509,1109300
3047,382,330,453463,6698,1789839,1097900
3048,354,351,453113,6697,1790190,1095900
3049,356,345,452764,6701,1790535,1102400
3050,360,345,452393,6727,1790880,1134600
3051,325,338,452064,6718,1791218,1074600
3052,373,352,451684,6746,1791570,1080600
3053,334,352,451357,6721,1791922,1049200
3054,352,347,450999,6732,1792269,1073900
3055,360,388,450654,6689,1792657,1079000
3056,372,364,450292,6687,1793021,1045100
3057,397,344,449886,6749,1793365,1072500
3058,386,347,449504,6784,1793712,1235700
3059,344,378,449155,6755,1794090,1219200
3060,349,364,448796,6750,1794454,1140700
3061,377,363,448428,6755,1794817,1222600
3062,352,342,448061,6780,1795159,1000300
3063,377,329,447704,6808,1795488,1057500
3064,366,349,447331,6832,1795837,1010400
3065,363,384,446972,6807,1796221,988200
3066,331,359,446627,6793,1796580,1013300
3067,355,339,446280,6801,1796919,1070300
3068,350,355,445931,6795,1797274,1087800
3069,402,340,445528,6858,1797614,1087400
3070,354,373,445173,6840,1797987,1132800
3071,322,375,444847,6791,1798362,1077200
3072,343,346,444509,6783,1798708,1134400
3073,369,319,444132,6841,1799027,1172300
3074,323,364,443823,6786,1799391,1079500
3075,355,342,443467,6800,1799733,1128100
3076,322,362,443126,6779,1800095,1168900
3077,319,341,442823,6741,1800436,1170900
3078,354,357,442464,6743,1800793,1225500
3079,335,330,442141,6736,1801123,1126700
3080,345,314,441786,6777,1801437,1127600
3081,347,300,441431,6832,1801737,1174900
3082,364,321,441089,6853,1802058,1205400
3083,358,337,440723,6882,1802395,1226200
3084,411,341,440319,6945,1802736,1202000
3085,365,368,439952,6944,1803104,1471000
3086,361,360,439587,6949,1803464,1216300
3087,339,369,439240,6927,1803833,1179500
3088,394,353,438853,6961,1804186,1190100
3089,357,362,438482,6970,1804548,1085300
3090,366,362,438134,6956,1804910,1107700
3091,373,364,437752,6974,1805274,1020900
3092,347,380,437421,6925,1805654,1055200
3093,367,337,437029,6980,1805991,1082300
3094,381,350,436673,6986,1806341,1056800
3095,356,352,436300,7007,1806693,1048300
3096,354,349,435948,7010,1807042,1128600
3097,361,356,435598,7004,1807398,1153300
3098,371,339,435203,7060,1807737,1093800
3099,382,385,434826,7052,1808122,1068300
3100,382,384,434472,7022,1808506,1055900
3101,342,384,434112,6998,1808890,998900
3102,405,365,433715,7030,1809255,1073500
3103,354,352,433346,7047,1809607,1079400
3104,362,352,432984,7057,1809959,1052700
3105,354,350,432624,7067,1810309,1021200
3106,359,408,432270,7013,1810717,1083400
3107,320,339,431945,6999,1811056,1091700
3108,352,385,431606,6953,1811441,1099000
3109,346,335,431253,6971,1811776,1108200
3110,382,358,430869,6997,1812134,1160400
3111,356,383,430523,6960,1812517,1084000
3112,339,349,430164,6970,1812866,1076700
3113,359,376,429820,6938,1813242,1063600
3114,331,361,429477,6920,1813603,1059900
3115,314,381,429162,6854,1813984,1063100
3116,353,346,428811,6859,1814330,1028600
3117,329,344,428472,6854,1814674,1078500
3118,363,349,428131,6846,1815023,1115500
3119,382,371,427765,6841,1815394,1003600
3120,355,360,427386,6860,1815754,1028400
3121,323,353,427062,6831,1816107,1035000
3122,353,342,426706,6845,1816449,1156200
3123,379,328,426329,6894,1816777,1155200
3124,408,377,425934,6912,1817154,1167300
3125,382,342,425556,6948,1817496,1203800
3126,369,412,425178,6914,1817908,1162500
3127,310,357,424875,6860,1818265,1182200
3128,380,331,424488,6916,1818596,1105200
3129,363,361,424122,6921,1818957,1208700
3130,357,366,423784,6893,1819323,1126600
3131,379,342,423396,6939,1819665,1147800
3132,364,331,423023,6981,1819996,1069400
3133,318,365,422695,6944,1820361,1038800
3134,349,403,422359,6877,1820764,1159900
3135,345,358,422002,6876,1821122,1218300
3136,363,341,421649,6888,1821463,1303100
3137,330,372,421322,6843,1821835,1148100
3138,339,359,420982,6824,1822194,1216300
3139,321,362,420654,6790,1822556,1225500
3140,389,348,420274,6822,1822904,1192100
3141,339,361,419921,6814,1823265,1127100
3142,331,361,419587,6787,1823626,1154800
3143,353,336,419234,6804,1823962,1241100
3144,335,354,418913,6771,1824316,1378200
3145,341,368,418577,6739,1824684,1310800
3146,343,364,418235,6717,1825048,1217100
3147,373,337,417857,6758,1825385,1149200
3148,359,368,417506,6741,1825753,1093000
3149,349,343,417137,6767,1826096,1123500
3150,337,362,416809,6733,1826458,1302900
3151,351,359,416463,6720,1826817,1291200
3152,345,342,416106,6735,1827159,1318100
3153,364,375,415755,6711,1827534,1203100
3154,359,348,415384,6734,1827882,1267200
3155,332,357,415061,6700,1828239,1219600
3156,384,361,414681,6719,1828600,1081600
3157,366,341,414320,6739,1828941,1124800
3158,350,331,413953,6775,1829272,1202100
3159,374,377,413602,6749,1829649,1207800
3160,318,356,413255,6740,1830005,1093300
3161,375,337,412889,6769,1830342,1124600
3162,346,321,412563,6774,1830663,1158300
3163,367,372,412186,6779,1831035,1090900
3164,347,329,411830,6806,1831364,1161200
3165,325,361,411503,6772,1831725,1122400
3166,359,325,411134,6816,1832050,1095600
3167,367,365,410774,6811,1832415,1106500
3168,361,345,410414,6826,1832760,1011100
3169,332,348,410091,6801,1833108,1068200
3170,353,324,409734,6834,1833432,1046800
3171,372,340,409373,6855,1833772,1136900
3172,347,347,409007,6874,1834119,1096300
3173,365,353,408650,6878,1834472,1081300
3174,331,349,408315,6864,1834821,1134600
3175,342,404,407981,6794,1835225,1145900
3176,341,366,407633,6776,1835591,1037800
3177,333,340,407299,6770,1835931,1113400
3178,329,395,406980,6694,1836326,1109500
3179,336,318,406642,6714,1836644,1144400
3180,352,365,406282,6709,1837009,1208300
3181,369,363,405914,6714,1837372,1338400
3182,348,351,405587,6690,1837723,1097100
3183,333,357,405231,6689,1838080,1098100
3184,342,328,404903,6689,1838408,1197200
3185,367,361,404534,6697,1838769,1163300
3186,318,375,404207,6649,1839144,1085100
3187,321,330,403874,6652,1839474,1174000
3188,334,366,403569,6591,1839840,1198600
3189,313,305,403242,6613,1840145,1299800
3190,327,356,402905,6594,1840501,1175800
3191,302,302,402609,6588,1840803,1168100
3192,335,303,402271,6623,1841106,1175800
3193,313,376,401953,6565,1841482,1301700
3194,328,343,401630,6545,1841825,1236900
3195,324,338,401297,6540,1842163,1178700
3196,364,357,400952,6528,1842520,1029900
3197,370,327,400592,6561,1842847,1177400
3198,338,323,400232,6598,1843170,1213500
3199,311,321,399921,6588,1843491,1258300
3200,333,356,399616,6537,1843847,1338600
3201,320,364,399275,6514,1844211,1178600
3202,333,373,398936,6480,1844584,1110400
3203,351,366,398585,6465,1844950,1098600
3204,327,358,398251,6441,1845308,1165900
3205,303,328,397965,6399,1845636,1228400
3206,320,316,397635,6413,1845952,1196700
3207,329,322,397308,6418,1846274,1157500
3208,352,333,396975,6418,1846607,1089300
3209,320,323,396632,6438,1846930,1232400
3210,345,371,396302,6397,1847301,1033400
3211,352,313,395948,6438,1847614,1035300
3212,332,362,395604,6420,1847976,1063000
3213,327,328,395274,6422,1848304,1144900
3214,329,320,394955,6421,1848624,1266700
3215,352,338,394596,6442,1848962,1132600
3216,310,320,394291,6427,1849282,1106700
3217,328,317,393976,6425,1849599,1076100
3218,324,333,393627,6441,1849932,1084100
3219,354,350,393295,6423,1850282,1128000
3220,354,333,392917,6468,1850615,1097400
3221,344,347,392601,6437,1850962,1134800
3222,352,338,392236,6464,1851300,1096900
3223,336,327,391897,6476,1851627,1076200
3224,332,298,391580,6495,1851925,1096400
3225,323,346,391256,6473,1852271,1042700
3226,363,365,390902,6462,1852636,1050600
3227,332,325,390551,6488,1852961,1077300
3228,334,329,390214,6496,1853290,1061600
3229,317,344,389892,6474,1853634,1068500
3230,354,378,389568,6420,1854012,1062700
3231,296,320,389236,6432,1854332,1139400
3232,341,316,388913,6439,1854648,1173300
3233,334,350,388597,6405,1854998,1193000
3234,344,330,388234,6438,1855328,1189100
3235,329,335,387906,6431,1855663,1115900
3236,361,326,387549,6462,1855989,1111900
3237,339,341,387203,6467,1856330,1158500
3238,298,345,386892,6433,1856675,1180600
3239,332,320,386565,6440,1856995,1235400
3240,342,323,386244,6438,1857318,1094100
3241,315,321,385912,6449,1857639,1137700
3242,320,343,385601,6417,1857982,1190200
3243,349,307,385253,6458,1858289,1198100
3244,329,345,384913,6453,1858634,1139200
3245,361,304,384571,6491,1858938,1076900
3246,333,349,384223,6490,1859287,1259100
3247,297,308,383918,6487,1859595,1187200
3248,331,321,383609,6475,1859916,1263800
3249,317,353,383283,6448,1860269,1251800
3250,304,338,382975,6418,1860607,1357900
3251,294,341,382658,6394,1860948,1260100
3252,327,346,382350,6356,1861294,1210600
3253,346,375,381994,6337,1861669,1123000
3254,338,325,381668,6338,1861994,1193200
3255,335,344,381335,6327,1862338,1184900
3256,337,335,381004,6323,1862673,1327600
3257,367,345,380656,6326,1863018,1410500
3258,328,346,380308,6328,1863364,1241900
3259,348,322,379955,6359,1863686,1196100
3260,308,316,379654,6344,1864002,1122900
3261,316,334,379336,6328,1864336,1149700
3262,312,312,379012,6340,1864648,1198800
3263,328,323,378691,6338,1864971,1286700
3264,341,306,378348,6375,1865277,1269300
3265,354,324,378002,6397,1865601,1142400
3266,317,333,377675,6391,1865934,1222900
3267,318,306,377352,6408,1866240,1273400
3268,309,322,377047,6391,1866562,1122200
3269,359,303,376692,6443,1866865,1146400
3270,347,337,376342,6456,1867202,1203200
3271,343,330,375996,6472,1867532,1207500
3272,309,374,375703,6391,1867906,1164900
3273,332,317,375351,6426,1868223,1082500
3274,359,338,375008,6431,1868561,1116600
3275,358,316,374652,6471,1868877,1255300
3276,334,340,374317,6466,1869217,1216700
3277,345,309,373971,6503,1869526,1141000
3278,313,340,373661,6473,1869866,1128400
3279,329,286,373323,6525,1870152,1072300
3280,378,358,372955,6535,1870510,1073800
3281,333,383,372612,6495,1870893,1150900
3282,334,317,372277,6513,1871210,1196400
3283,319,336,371973,6481,1871546,1213200
3284,366,325,371598,6531,1871871,1146400
3285,360,312,371240,6577,1872183,1119200
3286,348,326,370894,6597,1872509,1121600
3287,341,337,370550,6604,1872846,1057200
3288,316,364,370230,6560,1873210,1221900
3289,322,337,369906,6547,1873547,1165300
3290,347,325,369558,6570,1873872,1213900
3291,325,298,369234,6596,1874170,1190500
3292,321,315,368923,6592,1874485,2563200
3293,335,337,368575,6603,1874822,1217900
3294,377,323,368213,6642,1875145,1388200
3295,349,343,367863,6649,1875488,1228200
3296,389,352,367467,6693,1875840,1248500
3297,361,331,367108,6721,1876171,1205000
3298,342,338,366762,6729,1876509,1309600
3299,374,336,366387,6768,1876845,1224800
3300,338,347,366049,6759,1877192,1178400
3301,347,375,365695,6738,1877567,1196500
3302,325,363,365373,6697,1877930,1131700
3303,331,355,365039,6676,1878285,1197100
3304,337,354,364704,6657,1878639,1229600
3305,306,324,364399,6638,1878963,1294400
3306,353,361,364052,6624,1879324,1382700
3307,330,353,363703,6620,1879677,1231500
3308,361,308,363363,6652,1879985,1260100
3309,336,319,363017,6679,1880304,1265400
3310,373,345,362670,6681,1880649,1181100
3311,332,348,362336,6667,1880997,1191100
3312,318,358,361992,6653,1881355,1220100
3313,326,366,361682,6597,1881721,1147300
3314,337,340,361345,6594,1882061,1225300
3315,364,339,360983,6617,1882400,1103200
3316,347,337,360624,6639,1882737,1109800
3317,337,346,360293,6624,1883083,1170200
3318,319,318,359960,6639,1883401,1133700
3319,356,327,359613,6659,1883728,1039900
3320,310,298,359303,6671,1884026,1082700
3321,353,367,358943,6664,1884393,1048500
3322,312,371,358634,6602,1884764,1286600
3323,328,362,358313,6561,1885126,1261000
3324,335,329,357974,6571,1885455,1162800
3325,329,333,357635,6577,1885788,1169700
3326,321,314,357344,6554,1886102,1126900
3327,272,320,357043,6535,1886422,1186600
3328,333,328,356744,6506,1886750,1071500
3329,357,350,356374,6526,1887100,1078600
3330,363,313,356019,6568,1887413,1158200
3331,337,366,355665,6556,1887779,1394600
3332,366,361,355315,6545,1888140,1319800
3333,342,354,354955,6551,1888494,1273400
3334,357,363,354609,6534,1888857,1171200
3335,335,326,354257,6560,1889183,1157800
3336,337,354,353946,6517,1889537,1146800
3337,325,336,353604,6523,1889873,1207700
3338,390,347,353207,6573,1890220,1192100
3339,352,351,352861,6568,1890571,1178800
3340,330,333,352517,6579,1890904,1108500
3341,349,320,352180,6596,1891224,1275600
3342,373,325,351813,6638,1891549,1118100
3343,341,369,351457,6625,1891918,1200400
3344,345,353,351134,6595,1892271,1295500
3345,387,384,350733,6612,1892655,1203400
3346,325,321,350421,6603,1892976,1317700
3347,339,370,350064,6590,1893346,1202600
3348,328,331,349748,6575,1893677,1213300
3349,346,327,349402,6594,1894004,1213500
3350,356,354,349042,6600,1894358,1256900
3351,344,349,348702,6591,1894707,1151700
3352,345,346,348357,6590,1895053,1106100
3353,354,313,348014,6620,1895366,1063500
3354,330,371,347678,6585,1895737,1227500
3355,353,327,347325,6611,1896064,1216900
3356,362,354,346972,6610,1896418,1193800
3357,353,345,346604,6633,1896763,1069500
3358,354,345,346256,6636,1897108,1035700
3359,335,329,345907,6656,1897437,1173500
3360,359,320,345554,6689,1897757,1062700
3361,320,332,345226,6685,1898089,1027100
3362,323,335,344912,6664,1898424,1090000
3363,349,368,344560,6648,1898792,1257800
3364,348,343,344215,6650,1899135,1355700
3365,328,358,343893,6614,1899493,1120200
3366,363,376,343525,6606,1899869,1078200
3367,358,317,343172,6642,1900186,1190800
3368,346,340,342801,6673,1900526,1342100
3369,350,341,342466,6667,1900867,1079800
3370,346,357,342118,6658,1901224,1047100
3371,353,341,341764,6671,1901565,1060000
3372,354,352,341424,6659,1901917,1029100
3373,362,364,341060,6659,1902281,1041300
3374,309,356,340742,6621,1902637,997800
3375,288,343,340459,6561,1902980,1014900
3376,344,359,340126,6535,1903339,1047400
3377,354,323,339762,6576,1903662,1091400
3378,327,343,339431,6564,1904005,1064700
3379,318,321,339114,6560,1904326,1055200
3380,334,319,338783,6572,1904645,1015600
3381,340,356,338443,6556,1905001,1040400
3382,327,317,338105,6577,1905318,1042500
3383,336,334,337786,6562,1905652,1274200
3384,297,338,337469,6541,1905990,1078100
3385,356,331,337133,6546,1906321,1021100
3386,334,379,336786,6514,1906700,1022000
3387,328,358,336463,6479,1907058,1007400
3388,351,311,336114,6517,1907369,1057000
3389,338,305,335765,6561,1907674,1048600
3390,336,379,335441,6506,1908053,1055200
3391,348,337,335087,6523,1908390,1022400
3392,345,325,334752,6533,1908715,1121200
3393,327,333,334408,6544,1909048,992500
3394,346,334,334067,6551,1909382,1067100
3395,357,333,333714,6571,1909715,1037300
3396,345,343,333375,6567,1910058,1047900
3397,324,350,333050,6542,1910408,999500
3398,291,328,332732,6532,1910736,1059700
3399,320,326,332427,6511,1911062,1010300
3400,322,313,332124,6501,1911375,995900
3401,331,299,331780,6546,1911674,1037300
3402,345,334,331436,6556,1912008,1015000
3403,338,343,331096,6553,1912351,1048000
3404,299,337,330785,6527,1912688,1038300
3405,323,322,330478,6512,1913010,993000
3406,359,355,330113,6522,1913365,1069500
3407,319,355,329795,6485,1913720,1046800
3408,334,347,329457,6476,1914067,958800
3409,325,337,329133,6463,1914404,1005500
3410,310,329,328835,6432,1914733,1023700
3411,275,347,328530,6390,1915080,990600
3412,310,304,328230,6386,1915384,1047300
3413,293,324,327945,6347,1915708,1081100
3414,309,317,327633,6342,1916025,1097900
3415,340,336,327299,6340,1916361,1020100
3416,334,318,326975,6346,1916679,1019900
3417,290,322,326661,6338,1917001,1024600
3418,305,312,326369,6318,1917313,1004700
3419,317,332,326046,6309,1917645,1010700
3420,320,313,325727,6315,1917958,1075500
3421,300,314,325430,6298,1918272,1178600
3422,305,331,325122,6275,1918603,1203400
3423,309,297,324811,6289,1918900,1048400
3424,326,333,324489,6278,1919233,1064200
3425,309,311,324175,6281,1919544,1147600
3426,327,321,323857,6278,1919865,1173800
3427,322,313,323527,6295,1920178,1154700
3428,321,336,323221,6265,1920514,1031300
3429,332,286,322880,6320,1920800,1087400
3430,318,322,322563,6315,1921122,1082700
3431,307,305,322252,6321,1921427,1038700
3432,331,323,321926,6324,1921750,1055300
3433,301,346,321617,6287,1922096,1002100
3434,309,290,321308,6306,1922386,1075600
3435,304,352,321010,6252,1922738,993200
3436,337,317,320672,6273,1923055,1069900
3437,308,326,320359,6260,1923381,1053600
3438,304,308,320061,6250,1923689,1108400
3439,288,339,319749,6223,1924028,1029300
3440,300,285,319472,6215,1924313,1026800
3441,320,348,319156,6183,1924661,989300
3442,251,331,318892,6116,1924992,979100
3443,291,326,318592,6090,1925318,992900
3444,284,298,318314,6070,1925616,1039600
3445,304,295,318016,6073,1925911,1070600
3446,306,302,317710,6077,1926213,1113100
3447,291,300,317416,6071,1926513,1112200
3448,313,299,317122,6066,1926812,1195200
3449,288,293,316808,6087,1927105,1154900
3450,294,351,316518,6026,1927456,1152100
3451,291,334,316230,5980,1927790,1047300
3452,272,303,315968,5939,1928093,1041700
3453,299,300,315668,5939,1928393,1037900
3454,293,310,315367,5930,1928703,1178700
3455,280,297,315091,5909,1929000,1156800
3456,247,300,314827,5873,1929300,1134300
3457,258,296,314576,5828,1929596,1124800
3458,267,276,314317,5811,1929872,1144200
3459,304,328,314032,5768,1930200,1104500
3460,288,293,313729,5778,1930493,1158300
3461,298,316,313434,5757,1930809,1186900
3462,323,300,313109,5782,1931109,1119300
3463,305,315,312798,5778,1931424,1208400
3464,306,322,312498,5756,1931746,1203400
3465,307,326,312196,5732,1932072,1108700
3466,323,274,311864,5790,1932346,1162300
3467,317,275,311552,5827,1932621,1170600
3468,325,279,311244,5856,1932900,1184500
3469,290,291,310929,5880,1933191,1078100
3470,288,272,310644,5893,1933463,1163800
3471,308,305,310340,5892,1933768,1230300
3472,263,281,310063,5888,1934049,1566200
3473,299,317,309771,5863,1934366,1149100
3474,267,309,309502,5823,1934675,1147400
3475,258,286,309239,5800,1934961,1119600
3476,283,300,308963,5776,1935261,1236400
3477,273,263,308685,5791,1935524,1204000
3478,277,321,308419,5736,1935845,1197600
3479,269,329,308152,5674,1936174,1141800
3480,326,296,307829,5701,1936470,1238400
3481,285,316,307524,5690,1936786,1246100
3482,279,295,307261,5658,1937081,1127700
3483,273,291,306979,5649,1937372,1313600
3484,271,307,306704,5617,1937679,1286800
3485,300,280,306393,5648,1937959,1307300
3486,282,307,306127,5607,1938266,1195000
3487,242,285,305883,5566,1938551,1233300
3488,253,282,305624,5543,1938833,1390300
3489,268,261,305361,5545,1939094,1236300
3490,288,285,305073,5548,1939379,1354900
3491,272,279,304803,5539,1939658,1212800
3492,257,309,304537,5496,1939967,1215600
3493,276,295,304271,5467,1940262,1154600
3494,294,299,303976,5463,1940561,1149500
3495,298,293,303686,5460,1940854,1362700
3496,289,299,303384,5463,1941153,1176600
3497,296,285,303098,5464,1941438,1242300
3498,329,282,302781,5499,1941720,1467700
3499,282,276,302481,5523,1941996,1483400
3500,298,276,302187,5541,1942272,1385200
3501,323,308,301874,5546,1942580,1350900
3502,316,311,301550,5559,1942891,1481800
3503,306,324,301253,5532,1943215,1331700
3504,324,277,300928,5580,1943492,1507600
3505,290,261,300619,5628,1943753,1395000
3506,309,287,300339,5621,1944040,1748000
3507,300,313,300024,5623,1944353,2032000
3508,336,291,299697,5659,1944644,1547400
3509,298,282,299387,5687,1944926,1436800
3510,294,287,299094,5693,1945213,1422200
3511,295,309,298791,5687,1945522,1389200
3512,300,269,298498,5711,1945791,1339000
3513,316,294,298173,5742,1946085,1327200
3514,307,307,297874,5734,1946392,1389400
3515,304,299,297568,5741,1946691,1483500
3516,333,286,297245,5778,1946977,1396900
3517,286,293,296961,5769,1947270,1382700
3518,295,314,296647,5769,1947584,1342600
3519,301,307,296348,5761,1947891,1382500
3520,286,322,296077,5710,1948213,1229300
3521,255,271,295804,5712,1948484,1444700
3522,278,286,295539,5691,1948770,1377000
3523,313,278,295211,5741,1949048,1477900
3524,291,323,294923,5706,1949371,1422300
3525,294,259,294636,5734,1949630,1478000
3526,303,303,294340,5727,1949933,1392400
3527,326,299,294010,5758,1950232,1404500
3528,284,345,293733,5690,1950577,1318500
3529,308,312,293420,5691,1950889,1413800
3530,303,295,293107,5709,1951184,1472100
3531,294,304,292821,5691,1951488,1391800
3532,260,312,292555,5645,1951800,1531400
3533,280,268,292272,5660,1952068,1721400
3534,301,282,291991,5659,1952350,1362900
3535,285,287,291705,5658,1952637,1249600
3536,255,291,291428,5644,1952928,1358000
3537,282,290,291150,5632,1953218,1432300
3538,278,265,290872,5645,1953483,1308300
3539,266,273,290596,5648,1953756,1215100
3540,252,294,290351,5599,1954050,1223700
3541,289,287,290075,5588,1954337,1216000
3542,283,276,289783,5604,1954613,1134900
3543,287,296,289510,5581,1954909,1195900
3544,241,270,289257,5564,1955179,1297200
3545,258,259,288995,5567,1955438,1307700
3546,281,276,288723,5563,1955714,1356400
3547,290,286,288430,5570,1956000,1316200
3548,306,323,288130,5547,1956323,1320400
3549,317,302,287815,5560,1956625,1259600
3550,288,302,287518,5555,1956927,1490600
3551,309,268,287208,5597,1957195,1359000
3552,288,286,286926,5593,1957481,1415900
3553,294,302,286637,5580,1957783,1212500
3554,268,278,286359,5580,1958061,1233200
3555,277,314,286097,5528,1958375,1262200
3556,286,281,285808,5536,1958656,1723200
3557,246,243,285545,5556,1958899,1467800
3558,282,263,285263,5575,1959162,1521900
3559,267,267,284993,5578,1959429,1676100
3560,260,292,284738,5541,1959721,1809700
3561,256,285,284494,5500,1960006,2179900
3562,305,297,284192,5505,1960303,1434000
3563,285,269,283890,5538,1960572,1575400
3564,250,323,283634,5471,1960895,1383900
3565,272,287,283362,5456,1961182,1551700
3566,317,254,283067,5497,1961436,1403000
3567,262,283,282798,5483,1961719,1432600
3568,269,267,282542,5472,1961986,1619600
3569,288,280,282242,5492,1962266,1499300
3570,254,256,281983,5495,1962522,1381600
3571,295,295,281690,5493,1962817,1362600
3572,257,299,281432,5452,1963116,1342000
3573,224,295,281200,5389,1963411,1333000
3574,289,283,280926,5380,1963694,1724100
3575,310,290,280618,5398,1963984,1462000
3576,262,286,280339,5391,1964270,1903900
3577,281,273,280071,5386,1964543,2027300
3578,270,295,279782,5380,1964838,1508900
3579,307,278,279496,5388,1965116,1717000
3580,253,282,279229,5373,1965398,1842800
3581,244,279,278982,5341,1965677,1619100
3582,273,289,278711,5323,1965966,1451200
3583,256,296,278469,5269,1966262,1495400
3584,300,261,278170,5307,1966523,1410900
3585,264,280,277896,5301,1966803,1439000
3586,264,261,277629,5307,1967064,1351800
3587,265,263,277367,5306,1967327,1682600
3588,249,276,277108,5289,1967603,1648100
3589,262,248,276864,5285,1967851,1322700
3590,264,292,276599,5258,1968143,1333300
3591,287,297,276310,5250,1968440,1294200
3592,256,271,276044,5245,1968711,1387900
3593,273,292,275784,5213,1969003,1241200
3594,236,280,275524,5193,1969283,1432000
3595,255,243,275286,5188,1969526,1213900
3596,247,293,275026,5155,1969819,1345300
3597,252,253,274788,5140,1970072,1312100
3598,254,278,274527,5123,1970350,1237200
3599,239,277,274287,5086,1970627,1112800
3600,257,275,274034,5064,1970902,1190600
3601,274,289,273767,5042,1971191,1303200
3602,231,268,273529,5012,1971459,1312500
3603,261,273,273272,4996,1971732,1186400
3604,249,255,273015,4998,1971987,1135800
3605,243,262,272778,4973,1972249,1111900
3606,218,230,272547,4974,1972479,1055900
3607,257,291,272302,4928,1972770,1046500
3608,267,258,272031,4941,1973028,1053200
3609,262,272,271761,4939,1973300,1038700
3610,269,254,271511,4935,1973554,1161300
3611,269,256,271237,4953,1973810,1061100
3612,248,244,270990,4956,1974054,1036700
3613,249,269,270728,4949,1974323,1010400
3614,233,274,270505,4898,1974597,1105700
3615,268,273,270245,4885,1974870,964700
3616,234,274,269993,4863,1975144,1023300
3617,260,237,269739,4880,1975381,1000700
3618,249,250,269495,4874,1975631,1074900
3619,244,250,269240,4879,1975881,1069700
3620,289,243,268968,4908,1976124,1105700
3621,266,260,268689,4927,1976384,1108800
3622,239,234,268466,4916,1976618,1147200
3623,245,228,268202,4952,1976846,1184000
3624,228,251,267987,4916,1977097,1269100
3625,253,251,267724,4928,1977348,1222300
3626,246,238,267476,4938,1977586,1300200
3627,267,238,267215,4961,1977824,1217500
3628,249,248,266978,4950,1978072,1176400
3629,233,258,266731,4939,1978330,1409800
3630,251,231,266481,4958,1978561,1223000
3631,236,230,266234,4975,1978791,1221700
3632,231,273,266018,4918,1979064,1281900
3633,247,269,265770,4897,1979333,1177400
3634,240,258,265528,4881,1979591,1076900
3635,246,232,265272,4905,1979823,1112200
3636,228,238,265056,4883,1980061,1106700
3637,237,228,264815,4896,1980289,1083000
3638,256,239,264565,4907,1980528,1140900
3639,247,236,264321,4915,1980764,1074500
3640,239,248,264073,4915,1981012,1148900
3641,227,253,263835,4900,1981265,1174800
3642,280,269,263575,4891,1981534,1268600
3643,258,224,263323,4919,1981758,1209800
3644,266,254,263045,4943,1982012,1257600
3645,234,252,262808,4928,1982264,1298500
3646,255,225,262559,4952,1982489,1217000
3647,244,242,262299,4970,1982731,1208100
3648,225,240,262071,4958,1982971,1175700
3649,253,264,261838,4927,1983235,1189000
3650,244,239,261584,4942,1983474,1193300
3651,279,288,261313,4925,1983762,1129400
3652,239,249,261083,4906,1984011,1147000
3653,252,272,260820,4897,1984283,1038500
3654,261,251,260571,4895,1984534,1083600
3655,258,238,260311,4917,1984772,1180400
3656,226,256,260074,4898,1985028,1041800
3657,227,248,259840,4884,1985276,1143500
3658,216,254,259627,4843,1985530,1117500
3659,203,241,259418,4811,1985771,1121300
3660,243,246,259181,4802,1986017,1195900
3661,248,261,258933,4789,1986278,1253100
3662,237,260,258705,4757,1986538,1384700
3663,225,261,258464,4737,1986799,1400900
3664,273,255,258224,4722,1987054,1350600
3665,257,251,257943,4752,1987305,1516000
3666,234,243,257698,4754,1987548,1371900
3667,234,261,257478,4713,1987809,1444400
3668,230,231,257248,4712,1988040,1337000
3669,256,271,256995,4694,1988311,1443200
3670,224,242,256764,4683,1988553,1527600
3671,232,234,256536,4677,1988787,1333600
3672,243,213,256302,4698,1989000,1257700
3673,309,242,256001,4757,1989242,1246800
3674,271,238,255714,4806,1989480,1200400
3675,266,258,255448,4814,1989738,1257700
3676,268,242,255186,4834,1989980,1128400
3677,228,211,254935,4874,1990191,1121200
3678,260,263,254701,4845,1990454,1150500
3679,237,251,254459,4836,1990705,1206500
3680,270,238,254201,4856,1990943,1437100
3681,272,256,253899,4902,1991199,1264100
3682,252,273,253660,4868,1991472,1173400
3683,281,248,253386,4894,1991720,1270800
3684,265,249,253110,4921,1991969,1246600
3685,259,243,252858,4930,1992212,1298900
3686,220,236,252629,4923,1992448,1385100
3687,256,284,252374,4894,1992732,1229900
3688,207,251,252173,4844,1992983,1117100
3689,255,242,251915,4860,1993225,1261400
3690,267,268,251662,4845,1993493,1229000
3691,271,271,251381,4855,1993764,1203900
3692,283,251,251110,4875,1994015,1237100
3693,255,251,250836,4898,1994266,1248500
3694,269,263,250571,4900,1994529,1187100
3695,247,244,250340,4887,1994773,1215700
3696,286,262,250047,4918,1995035,1142400
3697,244,232,249792,4941,1995267,1270500
3698,277,257,249531,4945,1995524,1273100
3699,268,250,249243,4983,1995774,1257000
3700,274,264,248978,4984,1996038,1143700
3701,312,267,248667,5028,1996305,1139300
3702,264,267,248400,5028,1996572,1122900
3703,269,248,248124,5056,1996820,1114000
3704,274,248,247858,5074,1997068,1217700
3705,260,287,247586,5059,1997355,1296700
3706,269,236,247337,5072,1997591,1262100
3707,235,254,247094,5061,1997845,1504000
3708,262,283,246840,5032,1998128,1337500
3709,287,271,246548,5053,1998399,1240500
3710,238,268,246300,5033,1998667,1334700
3711,256,217,246050,5066,1998884,1292000
3712,261,279,245786,5051,1999163,1199100
3713,246,272,245552,5013,1999435,1170800
3714,232,262,245300,5003,1999697,1240600
3715,238,265,245069,4969,1999962,1232200
3716,253,254,244818,4966,2000216,1164700
3717,209,249,244614,4921,2000465,1206500
3718,251,240,244359,4936,2000705,1344700
3719,253,270,244109,4916,2000975,1307100
3720,235,273,243873,4879,2001248,1226200
3721,216,255,243653,4844,2001503,1223300
3722,225,250,243421,4826,2001753,1345700
3723,212,264,243220,4763,2002017,1314100
3724,239,269,242976,4738,2002286,1347600
3725,216,282,242761,4671,2002568,1311600
3726,236,262,242520,4650,2002830,1221600
3727,219,241,242316,4613,2003071,1361300
3728,273,236,242040,4653,2003307,1340200
3729,233,233,241795,4665,2003540,1286600
3730,249,252,241547,4661,2003792,1295100
3731,278,236,241284,4688,2004028,1397900
3732,269,243,241004,4725,2004271,1248900
3733,248,229,240763,4737,2004500,1285700
3734,276,231,240488,4781,2004731,1438100
3735,264,260,240226,4783,2004991,1249700
3736,264,227,239947,4835,2005218,1299800
3737,258,254,239707,4821,2005472,1453400
3738,263,246,239427,4855,2005718,1708300
3739,277,273,239174,4835,2005991,1409700
3740,251,232,238913,4864,2006223,1280700
3741,286,262,238636,4879,2006485,1370500
3742,265,274,238362,4879,2006759,1320000
3743,270,252,238097,4892,2007011,1366900
3744,286,266,237805,4918,2007277,1337600
3745,266,247,237531,4945,2007524,1421600
3746,271,243,237263,4970,2007767,1394800
3747,298,246,236976,5011,2008013,1183300
3748,277,254,236692,5041,2008267,1246800
3749,260,268,236440,5025,2008535,1233600
3750,258,256,236172,5037,2008791,1136800
3751,246,260,235917,5032,2009051,1101200
3752,266,249,235659,5041,2009300,1387500
3753,268,255,235390,5055,2009555,1144700
3754,257,259,235141,5045,2009814,1150500
3755,287,293,234860,5033,2010107,1085600
3756,248,246,234601,5046,2010353,1173500
3757,266,251,234337,5059,2010604,1107300
3758,273,262,234071,5063,2010866,1076300
3759,287,258,233784,5092,2011124,1121500
3760,291,235,233476,5165,2011359,1085900
3761,283,273,233210,5158,2011632,1050700
3762,240,229,232960,5179,2011861,1246200
3763,268,281,232698,5160,2012142,1153600
3764,239,273,232452,5133,2012415,1278500
3765,258,277,232205,5103,2012692,1177500
3766,271,269,231925,5114,2012961,1164700
3767,239,281,231676,5082,2013242,1108600
3768,234,268,231439,5051,2013510,1168600
3769,244,263,231204,5023,2013773,1075900
3770,231,228,230979,5020,2014001,1128000
3771,222,223,230754,5022,2014224,1160300
3772,237,277,230507,4992,2014501,1242400
3773,240,271,230278,4950,2014772,1112300
3774,248,270,230019,4939,2015042,1200200
3775,247,248,229773,4937,2015290,1099300
3776,256,254,229533,4923,2015544,1080300
3777,248,230,229264,4962,2015774,1128200
3778,237,250,229047,4929,2016024,1299700
3779,224,268,228815,4893,2016292,1149800
3780,249,256,228561,4891,2016548,1201300
3781,260,270,228311,4871,2016818,1303800
3782,209,243,228088,4851,2017061,1399400
3783,215,242,227860,4837,2017303,1220700
3784,242,259,227638,4800,2017562,1566200
3785,265,266,227370,4802,2017828,1443500
3786,231,216,227150,4806,2018044,1480900
3787,206,274,226934,4748,2018318,1440800
3788,221,234,226715,4733,2018552,1265800
3789,240,266,226476,4706,2018818,1300200
3790,213,246,226253,4683,2019064,1307700
3791,214,229,226041,4666,2019293,1235000
3792,237,271,225811,4625,2019564,1440800
3793,207,234,225594,4608,2019798,1267000
3794,234,247,225367,4588,2020045,1242300
3795,239,211,225120,4624,2020256,1394300
3796,234,234,224887,4623,2020490,1189900
3797,232,230,224658,4622,2020720,1287200
3798,253,236,224414,4630,2020956,1150000
3799,235,220,224168,4656,2021176,1253500
3800,244,254,223932,4638,2021430,1143600
3801,232,241,223697,4632,2021671,1259400
3802,233,222,223466,4641,2021893,1193600
3803,260,241,223220,4646,2022134,1185700
3804,265,254,222945,4667,2022388,1302000
3805,247,232,222690,4690,2022620,1342000
3806,252,247,222446,4687,2022867,1224000
3807,254,250,222189,4694,2023117,1125400
3808,229,266,221956,4661,2023383,1197400
3809,240,230,221719,4668,2023613,1302300
3810,210,218,221504,4665,2023831,1499600
3811,241,238,221267,4664,2024069,1429600
3812,250,236,221015,4680,2024305,1421200
3813,225,253,220786,4656,2024558,1538600
3814,232,241,220562,4639,2024799,1500400
3815,217,231,220337,4633,2025030,1407200
3816,241,246,220103,4621,2025276,1434200
3817,233,226,219873,4625,2025502,1363300
3818,242,252,219624,4622,2025754,1306000
3819,269,205,219366,4675,2025959,1332800
3820,259,252,219109,4680,2026211,1255000
3821,224,244,218869,4676,2026455,1216300
3822,274,249,218609,4687,2026704,1310800
3823,254,250,218351,4695,2026954,1339800
3824,272,231,218078,4737,2027185,1423600
3825,261,270,217816,4729,2027455,1418800
3826,277,252,217546,4747,2027707,2036700
3827,269,255,217278,4760,2027962,1537300
3828,281,205,217000,4833,2028167,1868500
3829,262,244,216729,4860,2028411,1879700
3830,246,278,216481,4830,2028689,1755100
3831,252,249,216229,4833,2028938,2992400
3832,248,219,215979,4864,2029157,1880600
3833,263,272,215725,4846,2029429,1912000
3834,238,246,215475,4850,2029675,1497000
3835,213,246,215260,4819,2029921,1532000
3836,252,245,215014,4820,2030166,2136000
3837,243,229,214775,4830,2030395,1780600
3838,233,246,214537,4822,2030641,1790700
3839,245,241,214303,4815,2030882,1722600
3840,223,253,214063,4802,2031135,1821200
3841,227,233,213835,4797,2031368,1865000
3842,260,238,213590,4804,2031606,1534300
3843,253,248,213339,4807,2031854,1889200
3844,220,247,213113,4786,2032101,1587300
3845,240,222,212871,4806,2032323,2009100
3846,226,259,212643,4775,2032582,1895300
3847,247,225,212399,4794,2032807,1654600
3848,230,237,212167,4789,2033044,1615300
3849,245,248,211929,4779,2033292,1466700
3850,226,240,211702,4766,2033532,1459800
3851,221,260,211469,4739,2033792,1619200
3852,256,235,211213,4760,2034027,1831600
3853,216,257,211011,4705,2034284,1525300
3854,236,244,210772,4700,2034528,1496700
3855,235,235,210530,4707,2034763,1521500
3856,210,235,210316,4686,2034998,2087300
3857,217,228,210105,4669,2035226,1709100
3858,227,260,209871,4643,2035486,1636600
3859,232,234,209644,4636,2035720,1508700
3860,251,242,209402,4636,2035962,1247600
3861,240,239,209158,4641,2036201,1184700
3862,247,267,208902,4630,2036468,1098800
3863,243,231,208664,4637,2036699,1186300
3864,221,231,208446,4624,2036930,1114200
3865,241,239,208205,4626,2037169,1523200
3866,250,216,207964,4651,2037385,1704000
3867,244,233,207714,4668,2037618,1462700
3868,230,230,207471,4681,2037848,1476500
3869,253,255,207230,4667,2038103,1402500
3870,246,221,206988,4688,2038324,1401200
3871,253,237,206728,4711,2038561,1244100
3872,257,230,206478,4731,2038791,1316900
3873,238,247,206217,4745,2039038,1348500
3874,216,237,206018,4707,2039275,1390100
3875,224,238,205800,4687,2039513,1290800
3876,215,241,205578,4668,2039754,1341300
3877,235,270,205351,4625,2040024,1403800
3878,245,233,205106,4637,2040257,1375400
3879,213,227,204878,4638,2040484,1351400
3880,224,214,204658,4644,2040698,1685700
3881,220,246,204441,4615,2040944,1564300
3882,241,219,204199,4638,2041163,1423900
3883,218,239,203976,4622,2041402,1338600
3884,216,243,203766,4589,2041645,1310500
3885,218,226,203540,4589,2041871,1260100
3886,217,232,203322,4575,2042103,1364800
3887,214,226,203112,4559,2042329,1179400
3888,217,247,202880,4544,2042576,1177900
3889,239,212,202668,4544,2042788,1169500
3890,229,231,202431,4550,2043019,1131000
3891,255,255,202189,4537,2043274,1343200
3892,211,253,201951,4522,2043527,1088200
3893,219,217,201744,4512,2043744,1264400
3894,216,228,201517,4511,2043972,1174800
3895,251,209,201294,4525,2044181,1199700
3896,229,215,201063,4541,2044396,1209800
3897,194,218,200849,4537,2044614,1130300
3898,210,238,200641,4507,2044852,1103900
3899,239,233,200409,4506,2045085,1094400
3900,221,238,200183,4494,2045323,1195100
3901,244,227,199934,4516,2045550,1468100
3902,208,246,199730,4474,2045796,1382500
3903,223,227,199504,4473,2046023,1294300
3904,229,242,199285,4450,2046265,1267300
3905,226,243,199055,4437,2046508,1143300
3906,233,216,198823,4453,2046724,1155500
3907,239,211,198575,4490,2046935,1134800
3908,233,238,198356,4471,2047173,1113800
3909,251,205,198101,4521,2047378,1110000
3910,231,219,197865,4538,2047597,1068600
3911,238,257,197630,4516,2047854,1313700
3912,215,223,197407,4516,2048077,1154300
3913,245,215,197176,4532,2048292,1184600
3914,223,225,196952,4531,2048517,1117600
3915,219,215,196728,4540,2048732,1115000
3916,217,245,196504,4519,2048977,1220600
3917,248,233,196264,4526,2049210,1065800
3918,229,197,196026,4567,2049407,1156700
3919,231,241,195801,4551,2049648,1142100
3920,251,252,195551,4549,2049900,1176000
3921,229,251,195312,4537,2050151,1069700
3922,212,231,195100,4518,2050382,1109100
3923,243,231,194874,4513,2050613,1030500
3924,220,249,194645,4493,2050862,1142900
3925,205,240,194440,4458,2051102,1201200
3926,214,226,194233,4439,2051328,1137900
3927,228,236,194007,4429,2051564,1096800
3928,209,242,193794,4400,2051806,1261500
3929,227,259,193555,4380,2052065,1123400
3930,244,235,193326,4374,2052300,1101000
3931,216,215,193099,4386,2052515,1185600
3932,232,226,192873,4386,2052741,1236200
3933,219,223,192656,4380,2052964,1083600
3934,214,246,192434,4356,2053210,1202500
3935,225,217,192221,4352,2053427,1404100
3936,249,220,191966,4387,2053647,1248100
3937,247,225,191738,4390,2053872,1265500
3938,230,224,191487,4417,2054096,1208400
3939,227,232,191264,4408,2054328,1113300
3940,208,243,191047,4382,2054571,1136200
3941,235,226,190819,4384,2054797,1220700
3942,245,223,190574,4406,2055020,1275100
3943,218,238,190349,4393,2055258,1193300
3944,195,251,190150,4341,2055509,1176900
3945,182,206,189974,4311,2055715,1175100
3946,203,224,189784,4277,2055939,1199200
3947,220,228,189552,4281,2056167,1123900
3948,231,209,189322,4302,2056376,1112100
3949,230,245,189091,4288,2056621,1158300
3950,216,221,188871,4287,2056842,1133700
3951,225,240,188657,4261,2057082,1140200
3952,252,217,188402,4299,2057299,1134600
3953,246,212,188161,4328,2057511,1270800
3954,250,226,187911,4352,2057737,1177900
3955,234,211,187669,4383,2057948,1083800
3956,218,218,187455,4379,2058166,1157800
3957,232,247,187225,4362,2058413,1120100
3958,205,214,187011,4362,2058627,1056600
3959,223,252,186794,4327,2058879,1056100
3960,212,234,186574,4313,2059113,1185200
3961,241,209,186347,4331,2059322,1138500
3962,216,253,186110,4315,2059575,1207000
3963,207,231,185911,4283,2059806,1137000
3964,214,204,185710,4280,2060010,1113600
3965,193,199,185506,4285,2060209,1107100
3966,204,214,185298,4279,2060423,1133900
3967,213,217,185100,4260,2060640,1205500
3968,202,209,184891,4260,2060849,1131500
3969,211,200,184684,4267,2061049,1276300
3970,218,209,184466,4276,2061258,1208000
3971,199,228,184263,4251,2061486,1219700
3972,206,207,184055,4252,2061693,1201000
3973,208,225,183850,4232,2061918,1215500
3974,243,219,183609,4254,2062137,1229600
3975,262,223,183352,4288,2062360,1188000
3976,211,230,183132,4278,2062590,1593300
3977,222,196,182908,4306,2062786,1302200
3978,247,220,182673,4321,2063006,1258200
3979,217,225,182449,4320,2063231,1253300
3980,238,224,182213,4332,2063455,1290500
3981,231,201,181976,4368,2063656,1176400
3982,229,225,181741,4378,2063881,1230800
3983,222,230,181530,4359,2064111,1132900
3984,205,210,181322,4357,2064321,1141400
3985,225,223,181100,4356,2064544,1365200
3986,201,222,180906,4328,2064766,1248400
3987,214,223,180666,4345,2064989,1245500
3988,222,221,180477,4313,2065210,1240400
3989,225,216,180234,4340,2065426,1190000
3990,210,223,180023,4328,2065649,1272600
3991,224,233,179789,4329,2065882,1265700
3992,221,220,179580,4318,2066102,1303700
3993,237,210,179336,4352,2066312,1177800
3994,175,230,179163,4295,2066542,1209700
3995,209,229,178957,4272,2066771,2136000
3996,238,229,178728,4272,2067000,1199100
3997,231,222,178498,4280,2067222,1162700
3998,226,235,178266,4277,2067457,1104700
3999,220,225,178037,4281,2067682,1207400
4000,211,229,177831,4258,2067911,1420800
4001,225,210,177610,4269,2068121,1209500
4002,195,240,177410,4229,2068361,1378400
4003,183,233,177219,4187,2068594,1372400
4004,218,214,177015,4177,2068808,1187000
4005,219,212,176798,4182,2069020,1235800
4006,215,201,176578,4201,2069221,1232300
4007,212,224,176366,4189,2069445,1179800
4008,202,189,176160,4206,2069634,1259000
4009,211,212,175947,4207,2069846,1261200
4010,240,202,175719,4233,2070048,1204000
4011,214,221,175509,4222,2070269,1147000
4012,251,227,175246,4258,2070496,1112100
4013,216,201,175030,4273,2070697,1134400
4014,239,205,174797,4301,2070902,1203400
4015,228,222,174570,4306,2071124,1263300
4016,225,212,174328,4336,2071336,1176900
4017,244,195,174098,4371,2071531,1173600
4018,224,220,173872,4377,2071751,1266600
4019,222,214,173650,4385,2071965,1166400
4020,217,243,173432,4360,2072208,1280300
4021,220,233,173215,4344,2072441,1310500
4022,237,241,172972,4346,2072682,1229000
4023,242,232,172739,4347,2072914,1175100
4024,258,217,172471,4398,2073131,1150800
4025,249,228,172231,4410,2073359,1138200
4026,227,213,171996,4432,2073572,1147100
4027,209,219,171782,4427,2073791,1138800
4028,209,212,171580,4417,2074003,1175500
4029,233,204,171356,4437,2074207,1149500
4030,222,239,171120,4434,2074446,1267300
4031,217,232,170906,4416,2074678,1272500
4032,230,242,170678,4402,2074920,1146000
4033,216,210,170460,4410,2075130,1159700
4034,214,225,170247,4398,2075355,1118800
4035,216,249,170032,4364,2075604,1139900
4036,196,227,169835,4334,2075831,1156800
4037,215,220,169619,4330,2076051,1189300
4038,198,230,169420,4299,2076281,1073300
4039,216,207,169213,4299,2076488,1281300
4040,229,197,168984,4331,2076685,1335700
4041,224,205,168754,4356,2076890,1202200
4042,220,239,168520,4351,2077129,1320900
4043,225,260,168303,4308,2077389,1518800
4044,226,202,168084,4325,2077591,1366700
4045,195,229,167874,4306,2077820,1204200
4046,231,214,167650,4316,2078034,1089000
4047,228,218,167431,4317,2078252,1211200
4048,238,184,167195,4369,2078436,1464800
4049,226,247,166962,4355,2078683,1167400
4050,200,224,166760,4333,2078907,1270300
4051,225,214,166544,4335,2079121,1222900
4052,201,195,166345,4339,2079316,1164200
4053,233,204,166118,4362,2079520,1117800
4054,214,239,165887,4354,2079759,1456200
4055,212,213,165687,4341,2079972,1240000
4056,233,230,165462,4336,2080202,1262500
4057,226,254,165227,4317,2080456,1250700
4058,240,245,164985,4314,2080701,1247600
4059,210,213,164772,4314,2080914,1151600
4060,207,219,164552,4315,2081133,1243800
4061,212,207,164351,4309,2081340,1105400
4062,229,224,164121,4315,2081564,1164300
4063,230,224,163900,4312,2081788,1288900
4064,221,203,163674,4335,2081991,1170000
4065,231,216,163438,4355,2082207,1155000
4066,230,211,163212,4370,2082418,1095700
4067,227,220,162984,4378,2082638,1125900
4068,207,220,162780,4362,2082858,1028000
4069,211,233,162570,4339,2083091,1094000
4070,214,222,162350,4337,2083313,1029300
4071,188,228,162169,4290,2083541,1039400
4072,233,228,161944,4287,2083769,1116700
4073,233,213,161696,4322,2083982,1119400
4074,203,190,161501,4327,2084172,1144100
4075,229,227,161262,4339,2084399,1322500
4076,172,213,161081,4307,2084612,1183100
4077,231,233,160868,4287,2084845,1259500
4078,220,231,160631,4293,2085076,1243000
4079,226,257,160429,4238,2085333,1104500
4080,190,199,160215,4253,2085532,1249000
4081,207,210,160020,4238,2085742,1401600
4082,207,253,159811,4194,2085995,1210500
4083,216,226,159601,4178,2086221,1134300
4084,192,249,159401,4129,2086470,1188800
4085,197,207,159198,4125,2086677,1172900
4086,223,222,158978,4123,2086899,1207700
4087,201,199,158789,4113,2087098,1232800
4088,200,211,158575,4116,2087309,1222800
4089,214,204,158370,4117,2087513,1194000
4090,197,230,158173,4084,2087743,1270100
4091,179,221,157973,4063,2087964,1125800
4092,214,205,157777,4054,2088169,1286000
4093,183,214,157590,4027,2088383,1204200
4094,204,230,157398,3989,2088613,1308400
4095,208,213,157186,3988,2088826,1451000
4096,195,210,156991,3973,2089036,1390100
4097,192,233,156788,3943,2089269,1352000
4098,186,214,156607,3910,2089483,1347700
4099,184,193,156430,3894,2089676,1249900
4100,192,200,156225,3899,2089876,1170000
4101,199,197,156040,3887,2090073,1310100
4102,211,197,155827,3903,2090270,1158700
4103,192,226,155630,3874,2090496,1196300
4104,174,188,155452,3864,2090684,1148100
4105,189,210,155267,3839,2090894,1146300
4106,184,193,155073,3840,2091087,1208600
4107,189,188,154899,3826,2091275,1493900
4108,217,203,154681,3841,2091478,1600300
4109,190,210,154492,3820,2091688,1212300
4110,205,202,154276,3834,2091890,1198200
4111,184,198,154094,3818,2092088,1252200
4112,222,186,153887,3839,2092274,1110600
4113,190,176,153684,3866,2092450,1247900
4114,218,193,153483,3874,2092643,1323200
4115,213,207,153255,3895,2092850,1277200
4116,212,217,153047,3886,2093067,1199300
4117,206,196,152836,3901,2093263,1154100
4118,202,187,152643,3907,2093450,1138100
4119,211,201,152423,3926,2093651,1305500
4120,189,190,152233,3926,2093841,1172100
4121,178,200,152049,3910,2094041,1174400
4122,213,216,151860,3883,2094257,1193000
4123,207,221,151625,3897,2094478,1238200
4124,204,210,151439,3873,2094688,1273200
4125,198,206,151237,3869,2094894,1125100
4126,196,194,151042,3870,2095088,1228100
4127,207,184,150822,3906,2095272,1141800
4128,204,192,150631,3905,2095464,1255100
4129,201,185,150430,3921,2095649,1163000
4130,191,211,150250,3890,2095860,1169700
4131,184,187,150044,3909,2096047,1085200
4132,207,196,149864,3893,2096243,1237100
4133,188,200,149651,3906,2096443,1135100
4134,188,195,149472,3890,2096638,1220800
4135,214,190,149252,3920,2096828,1150500
4136,201,189,149050,3933,2097017,1166400
4137,171,199,148876,3908,2097216,1250400
4138,197,200,148684,3900,2097416,1144000
4139,183,214,148504,3866,2097630,1205500
4140,198,176,148315,3879,2097806,1271700
4141,212,191,148102,3901,2097997,1154500
4142,201,191,147883,3929,2098188,1229400
4143,177,214,147715,3883,2098402,1329800
4144,189,204,147518,3876,2098606,1350300
4145,205,197,147326,3871,2098803,1384300
4146,181,197,147139,3861,2099000,1324500
4147,215,190,146938,3872,2099190,1390900
4148,192,195,146736,3879,2099385,1364900
4149,199,219,146536,3860,2099604,1258400
4150,235,218,146305,3873,2099822,1219700
4151,208,213,146093,3872,2100035,1183200
4152,211,215,145882,3868,2100250,1257400
4153,165,199,145705,3846,2100449,1620500
4154,172,180,145535,3836,2100629,1280300
4155,185,209,145364,3798,2100838,1192800
4156,188,184,145173,3805,2101022,1240200
4157,226,194,144943,3841,2101216,1141200
4158,194,208,144750,3826,2101424,1260600
4159,207,219,144551,3806,2101643,1221500
4160,206,207,144333,3817,2101850,1218400
4161,195,199,144145,3806,2102049,1253400
4162,211,183,143941,3827,2102232,1263600
4163,223,205,143711,3852,2102437,1191000
4164,187,200,143523,3840,2102637,1166800
4165,198,193,143319,3851,2102830,1185000
4166,235,206,143099,3865,2103036,1077400
4167,187,220,142895,3849,2103256,1072500
4168,210,190,142696,3858,2103446,1204300
4169,199,178,142493,3883,2103624,1394300
4170,230,217,142265,3894,2103841,1169000
4171,210,214,142060,3885,2104055,1317800
4172,232,199,141824,3922,2104254,1199100
4173,223,209,141604,3933,2104463,1253400
4174,212,239,141391,3907,2104702,1244500
4175,217,193,141165,3940,2104895,1181300
4176,202,205,140972,3928,2105100,1317000
4177,210,206,140760,3934,2105306,1221800
4178,203,204,140562,3928,2105510,1250300
4179,203,212,140353,3925,2105722,1408600
4180,199,217,140144,3917,2105939,1168600
4181,170,191,139984,3886,2106130,1156800
4182,204,202,139773,3895,2106332,1222100
4183,185,207,139595,3866,2106539,1190800
4184,197,206,139393,3862,2106745,1210000
4185,182,182,139215,3858,2106927,1148400
4186,161,201,139036,3836,2107128,1141300
4187,177,186,138878,3808,2107314,1119200
4188,166,188,138714,3784,2107502,1148200
4189,196,195,138519,3784,2107697,1118900
4190,209,185,138302,3816,2107882,1305700
4191,213,211,138091,3816,2108093,1173900
4192,187,181,137904,3822,2108274,1174700
4193,194,179,137706,3841,2108453,1141600
4194,223,179,137500,3868,2108632,1209800
4195,218,189,137265,3914,2108821,1263800
4196,191,210,137082,3887,2109031,1282400
4197,178,209,136899,3861,2109240,1134600
4198,182,204,136723,3833,2109444,1253100
4199,184,206,136534,3816,2109650,1438600
4200,195,181,136350,3819,2109831,1394300
4201,171,212,136158,3799,2110043,1231100
4202,192,205,135966,3786,2110248,1223800
4203,213,185,135772,3795,2110433,1357900
4204,199,206,135573,3788,2110639,1328400
4205,223,171,135346,3844,2110810,1162800
4206,197,183,135140,3867,2110993,1220300
4207,172,179,134979,3849,2111172,1301400
4208,188,219,134778,3831,2111391,1329600
4209,217,199,134576,3834,2111590,1250300
4210,193,201,134377,3832,2111791,1252500
4211,221,206,134148,3855,2111997,1204300
4212,216,182,133935,3886,2112179,1114000
4213,184,191,133757,3873,2112370,1262700
4214,190,165,133559,3906,2112535,1273800
4215,218,194,133353,3918,2112729,1151000
4216,230,201,133129,3941,2112930,1167300
4217,189,193,132932,3945,2113123,1182100
4218,205,204,132720,3953,2113327,1263100
4219,208,202,132519,3952,2113529,1302600
4220,212,219,132317,3935,2113748,1275600
4221,194,193,132119,3940,2113941,1320400
4222,208,232,131903,3924,2114173,1203800
4223,223,187,131679,3961,2114360,1248400
4224,221,223,131459,3958,2114583,1231900
4225,195,219,131256,3942,2114802,1418000
4226,226,211,131041,3946,2115013,1297700
4227,177,213,130861,3913,2115226,1343700
4228,216,216,130643,3915,2115442,1193800
4229,214,191,130421,3946,2115633,1277300
4230,174,205,130257,3905,2115838,1255000
4231,217,199,130041,3922,2116037,1197900
4232,211,192,129829,3942,2116229,1131100
4233,213,215,129618,3938,2116444,1236000
4234,195,206,129414,3936,2116650,1145300
4235,177,191,129247,3912,2116841,1120200
4236,192,198,129048,3913,2117039,1156100
4237,180,223,128860,3878,2117262,1107800
4238,202,194,128666,3878,2117456,1051300
4239,188,213,128476,3855,2117669,1321700
4240,202,191,128276,3864,2117860,1214700
4241,201,200,128081,3859,2118060,1113700
4242,169,182,127900,3858,2118242,1118800
4243,194,199,127714,3845,2118441,1128100
4244,201,224,127519,3816,2118665,1277800
4245,195,205,127313,3817,2118870,1233500
4246,196,204,127121,3805,2119074,1234700
4247,169,193,126952,3781,2119267,1312800
4248,171,199,126778,3756,2119466,1203600
4249,198,199,126580,3755,2119665,1200600
4250,195,215,126385,3735,2119880,1265900
4251,179,206,126197,3717,2120086,1179300
4252,190,232,126010,3672,2120318,1266600
4253,190,182,125833,3667,2120500,1178700
4254,186,186,125644,3670,2120686,1311600
4255,206,184,125443,3687,2120870,1219000
4256,185,179,125257,3694,2121049,1224100
4257,198,200,125058,3693,2121249,1283000
4258,184,189,124859,3703,2121438,1348200
4259,196,204,124681,3677,2121642,1241600
4260,196,197,124478,3683,2121839,1178400
4261,203,179,124284,3698,2122018,1161100
4262,188,207,124084,3691,2122225,1147900
4263,178,179,123904,3692,2122404,1175200
4264,175,195,123731,3670,2122599,1500900
4265,168,198,123560,3643,2122797,1218100
4266,173,180,123390,3633,2122977,1213800
4267,185,171,123203,3649,2123148,1419500
4268,199,179,123020,3653,2123327,1339800
4269,190,178,122825,3670,2123505,1311400
4270,167,201,122641,3653,2123706,1326600
4271,189,164,122460,3670,2123870,1425700
4272,185,185,122274,3671,2124055,1234600
4273,183,171,122096,3678,2124226,1292100
4274,213,196,121895,3683,2124422,1775600
4275,208,205,121675,3698,2124627,1497500
4276,194,199,121481,3693,2124826,1396800
4277,196,200,121281,3693,2125026,1360200
4278,186,198,121101,3675,2125224,1286200
4279,190,183,120919,3674,2125407,1216300
4280,167,185,120731,3677,2125592,1341400
4281,192,174,120551,3683,2125766,1372100
4282,199,197,120344,3693,2125963,1303400
4283,206,173,120149,3715,2126136,1231400
4284,196,199,119943,3722,2126335,1166600
4285,207,193,119737,3735,2126528,1280300
4286,179,196,119558,3718,2126724,1242000
4287,204,187,119361,3728,2126911,1291700
4288,206,210,119152,3727,2127121,1154000
4289,210,174,118934,3771,2127295,1132900
4290,186,212,118749,3744,2127507,1269700
4291,195,201,118560,3732,2127708,1099500
4292,196,198,118363,3731,2127906,1105400
4293,209,197,118159,3738,2128103,1184500
4294,190,198,117973,3726,2128301,1124300
4295,208,186,117759,3754,2128487,1071300
4296,192,193,117566,3754,2128680,1132400
4297,203,228,117371,3721,2128908,1039300
4298,151,216,117203,3673,2129124,1157100
4299,173,213,117037,3626,2129337,1143600
4300,180,207,116861,3595,2129544,1259000
4301,196,214,116654,3588,2129758,1104200
4302,198,177,116464,3601,2129935,1036500
4303,172,181,116290,3594,2130116,1150500
4304,192,167,116104,3613,2130283,1189700
4305,198,209,115906,3602,2130492,1183900
4306,178,192,115719,3597,2130684,1251800
4307,182,193,115544,3579,2130877,1254500
4308,178,190,115363,3570,2131067,1167700
4309,186,201,115178,3554,2131268,1162000
4310,153,205,115013,3514,2131473,1111500
4311,173,159,114854,3514,2131632,1166800
4312,185,184,114663,3521,2131816,1139900
4313,185,194,114476,3514,2132010,1191200
4314,195,191,114287,3512,2132201,1210000
4315,200,175,114099,3525,2132376,1440200
4316,189,191,113892,3541,2132567,1344900
4317,196,201,113706,3526,2132768,1419000
4318,176,165,113519,3548,2132933,1324600
4319,188,151,113348,3568,2133084,1295100
4320,175,179,113153,3584,2133263,1388700
4321,195,169,112971,3597,2133432,1339900
4322,178,186,112784,3598,2133618,1448300
4323,176,195,112615,3572,2133813,1450300
4324,164,181,112439,3567,2133994,1534100
4325,200,178,112249,3579,2134172,1243900
4326,205,200,112053,3575,2134372,1220500
4327,182,189,111863,3576,2134561,1249000
4328,196,163,111661,3615,2134724,1263200
4329,195,200,111470,3606,2134924,1227700
4330,169,182,111308,3586,2135106,1269500
4331,193,196,111115,3583,2135302,1634900
4332,177,177,110934,3587,2135479,1486400
4333,186,184,110753,3584,2135663,1417800
4334,200,193,110545,3599,2135856,1374900
4335,198,171,110347,3626,2136027,2109600
4336,189,181,110158,3634,2136208,1575000
4337,176,172,109971,3649,2136380,1677800
4338,203,193,109779,3648,2136573,1674200
4339,150,202,109622,3603,2136775,1541900
4340,182,186,109451,3588,2136961,1449900
4341,184,192,109263,3584,2137153,1471300
4342,172,183,109097,3567,2137336,1477000
4343,164,193,108917,3554,2137529,1643000
4344,166,184,108754,3533,2137713,1702200
4345,171,183,108588,3516,2137896,1421100
4346,172,178,108422,3504,2138074,1414300
4347,177,165,108244,3517,2138239,1390800
4348,149,179,108095,3487,2138418,1300700
4349,158,158,107930,3494,2138576,1206400
4350,211,169,107723,3532,2138745,1296100
4351,172,183,107543,3529,2138928,1450100
4352,174,147,107368,3557,2139075,1701200
4353,157,175,107215,3535,2139250,1600100
4354,192,186,107035,3529,2139436,2124900
4355,200,192,106837,3535,2139628,1654300
4356,197,180,106630,3562,2139808,2021600
4357,181,167,106448,3577,2139975,1674700
4358,170,222,106274,3529,2140197,1371000
4359,186,179,106096,3528,2140376,1298700
4360,172,165,105918,3541,2140541,1344600
4361,166,161,105754,3544,2140702,1408000
4362,194,186,105560,3552,2140888,1309600
4363,187,163,105375,3574,2141051,1386200
4364,183,174,105202,3573,2141225,1461700
4365,190,196,105002,3577,2141421,1327200
4366,194,214,104807,3558,2141635,1340300
4367,178,195,104628,3542,2141830,1306200
4368,174,179,104453,3538,2142009,1405000
4369,169,193,104300,3498,2142202,1262500
4370,163,179,104113,3506,2142381,1258500
4371,201,177,103942,3500,2142558,1158700
4372,179,170,103737,3535,2142728,1282200
4373,185,161,103554,3557,2142889,1333800
4374,177,178,103386,3547,2143067,1232200
4375,186,173,103188,3572,2143240,1232400
4376,205,177,102994,3589,2143417,1257100
4377,170,187,102824,3572,2143604,1192800
4378,185,160,102637,3599,2143764,1128000
4379,188,183,102455,3598,2143947,1259100
4380,180,176,102266,3611,2144123,1308200
4381,192,196,102081,3600,2144319,1350900
4382,171,166,101907,3608,2144485,1231200
4383,173,187,101728,3600,2144672,1170100
4384,191,191,101549,3588,2144863,1172400
4385,184,183,101354,3600,2145046,1249500
4386,155,177,101205,3572,2145223,1129300
4387,190,203,101023,3551,2145426,1143900
4388,169,183,100836,3555,2145609,1127700
4389,164,166,100683,3542,2145775,1126200
4390,193,206,100496,3523,2145981,1141400
4391,188,178,100291,3550,2146159,1160500
4392,170,186,100143,3512,2146345,1125600
4393,213,169,99919,3567,2146514,1124700
4394,183,201,99730,3555,2146715,1258200
4395,186,183,99548,3554,2146898,1201000
4396,215,204,99340,3558,2147102,1187300
4397,197,163,99138,3597,2147265,1235300
4398,193,172,98946,3617,2147437,1287400
4399,186,170,98759,3634,2147607,1149700
4400,195,189,98569,3635,2147796,1227700
4401,198,171,98361,3672,2147967,1240200
4402,186,189,98182,3662,2148156,1097300
4403,194,172,97986,3686,2148328,1161500
4404,198,195,97790,3687,2148523,1125300
4405,176,176,97602,3699,2148699,1282200
4406,171,204,97432,3665,2148903,1152400
4407,189,215,97249,3633,2149118,1234400
4408,187,177,97066,3639,2149295,1311800
4409,180,184,96881,3640,2149479,1122900
4410,192,186,96696,3639,2149665,1165900
4411,207,187,96485,3663,2149852,1144900
4412,200,178,96296,3674,2150030,1110300
4413,200,194,96094,3682,2150224,1230900
4414,178,215,95904,3657,2150439,1089900
4415,173,207,95726,3628,2150646,1090600
4416,201,197,95533,3624,2150843,1086900
4417,196,202,95340,3615,2151045,1055200
4418,144,173,95187,3595,2151218,1153400
4419,178,210,95019,3553,2151428,1096700
4420,153,179,94855,3538,2151607,1107700
4421,182,192,94681,3520,2151799,1387500
4422,190,184,94485,3532,2151983,1224700
4423,202,188,94292,3537,2152171,1205900
4424,196,168,94097,3564,2152339,1086900
4425,204,178,93886,3597,2152517,1261800
4426,179,164,93707,3612,2152681,1147500
4427,180,192,93546,3581,2152873,1381700
4428,148,196,93372,3559,2153069,1227100
4429,176,176,93197,3558,2153245,1443000
4430,164,170,93039,3546,2153415,1227000
4431,167,181,92876,3528,2153596,1377800
4432,190,193,92682,3529,2153789,1392200
4433,167,191,92518,3502,2153980,1422300
4434,157,182,92353,3485,2154162,1467100
4435,189,187,92172,3479,2154349,1372900
4436,161,174,92002,3475,2154523,1405700
4437,150,184,91845,3448,2154707,1175200
4438,174,183,91677,3433,2154890,1083100
4439,168,172,91514,3424,2155062,1054900
4440,171,162,91348,3428,2155224,1342400
4441,166,171,91174,3431,2155395,1207000
4442,175,186,91005,3414,2155581,1073700
4443,164,198,90837,3384,2155779,1034000
4444,174,153,90665,3403,2155932,1170700
4445,173,178,90490,3400,2156110,1105400
4446,184,180,90313,3397,2156290,1081600
4447,162,179,90147,3384,2156469,1150500
4448,170,179,89979,3373,2156648,1043100
4449,186,180,89788,3384,2156828,1124600
4450,180,184,89606,3382,2157012,1174700
4451,157,189,89453,3346,2157201,1112300
4452,160,150,89292,3357,2157351,1077900
4453,158,169,89134,3346,2157520,1076300
4454,143,150,88980,3350,2157670,1268600
4455,163,151,88831,3348,2157821,1067800
4456,186,174,88644,3361,2157995,1065200
4457,159,177,88476,3352,2158172,1089000
4458,184,162,88298,3368,2158334,1181500
4459,170,157,88141,3368,2158491,1088800
4460,157,170,87980,3359,2158661,1072000
4461,201,173,87776,3390,2158834,1143400
4462,172,168,87598,3400,2159002,1073900
4463,163,165,87436,3397,2159167,1178500
4464,189,181,87244,3408,2159348,1299700
4465,179,160,87072,3420,2159508,1197300
4466,183,181,86886,3425,2159689,1260900
4467,162,170,86715,3426,2159859,1223500
4468,187,176,86542,3423,2160035,1200900
4469,175,174,86369,3422,2160209,1214300
4470,170,178,86191,3422,2160387,1111400
4471,195,181,85996,3436,2160568,1179000
4472,163,181,85836,3415,2160749,1048800
4473,157,182,85674,3395,2160931,1068500
4474,163,161,85511,3397,2161092,1121300
4475,188,170,85320,3418,2161262,1109800
4476,161,173,85156,3409,2161435,1155500
4477,172,172,84988,3405,2161607,1216500
4478,191,179,84812,3402,2161786,1179400
4479,171,178,84630,3406,2161964,1173800
4480,170,176,84457,3403,2162140,1108300
4481,168,166,84289,3405,2162306,1108200
4482,169,192,84129,3373,2162498,1144100
4483,189,164,83939,3399,2162662,1144800
4484,181,199,83753,3386,2162861,1212400
4485,161,204,83589,3346,2163065,1196100
4486,188,178,83403,3354,2163243,1158700
4487,175,179,83233,3345,2163422,1163700
4488,201,170,83031,3377,2163592,1082700
4489,153,194,82877,3337,2163786,1185800
4490,187,180,82693,3341,2163966,1247100
4491,153,174,82532,3328,2164140,1231200
4492,139,167,82385,3308,2164307,1139900
4493,145,164,82235,3294,2164471,1081600
4494,177,160,82074,3295,2164631,1149600
4495,153,219,81915,3235,2164850,1184800
4496,163,174,81756,3220,2165024,1294800
4497,152,159,81600,3217,2165183,1198100
4498,173,163,81430,3224,2165346,1264500
4499,156,153,81271,3230,2165499,1204200
4500,126,183,81148,3170,2165682,1107800
4501,164,169,80994,3155,2165851,1098200
4502,165,187,80811,3151,2166038,1212000
4503,163,154,80662,3146,2166192,1228700
4504,168,155,80490,3163,2166347,1206200
4505,165,151,80330,3172,2166498,1101000
4506,163,154,80154,3194,2166652,1307000
4507,162,178,80014,3156,2166830,1138500
4508,171,168,79832,3170,2166998,1154300
4509,195,167,79636,3199,2167165,1153500
4510,161,171,79463,3201,2167336,1090500
4511,174,157,79310,3197,2167493,1149800
4512,151,161,79134,3212,2167654,1153700
4513,146,169,79003,3174,2167823,1108900
4514,160,178,78842,3157,2168001,1068300
4515,154,153,78677,3169,2168154,1357700
4516,160,163,78526,3157,2168317,1325000
4517,162,186,78366,3131,2168503,1131800
4518,150,160,78220,3117,2168663,1082300
4519,168,152,78040,3145,2168815,1143700
4520,172,151,77885,3149,2168966,1643000
4521,164,158,77711,3165,2169124,1306300
4522,154,153,77555,3168,2169277,1348900
4523,163,186,77405,3132,2169463,1275000
4524,144,165,77245,3127,2169628,1344100
4525,152,143,77091,3138,2169771,1168900
4526,160,159,76941,3129,2169930,1122800
4527,165,156,76780,3134,2170086,1142900
4528,139,169,76637,3108,2170255,1240000
4529,150,168,76468,3109,2170423,1192300
4530,168,158,76318,3101,2170581,1179500
4531,164,151,76148,3120,2170732,1250200
4532,176,151,75985,3132,2170883,1258500
4533,172,172,75807,3138,2171055,1127400
4534,164,174,75645,3126,2171229,1123400
4535,185,158,75455,3158,2171387,1083400
4536,177,184,75290,3139,2171571,1261300
4537,141,152,75126,3151,2171723,1283400
4538,152,154,74986,3137,2171877,1146300
4539,182,164,74809,3150,2172041,1135700
4540,161,171,74639,3149,2172212,1157400
4541,131,162,74498,3128,2172374,1302900
4542,147,169,74365,3092,2172543,1128100
4543,161,159,74205,3093,2172702,1283900
4544,147,166,74052,3080,2172868,1185800
4545,145,143,73915,3074,2173011,1211000
4546,148,143,73764,3082,2173154,1160100
4547,139,158,73618,3070,2173312,1108700
4548,147,164,73474,3050,2173476,1152500
4549,149,174,73324,3026,2173650,1173900
4550,163,137,73164,3049,2173787,1255000
4551,176,159,72990,3064,2173946,1240100
4552,141,156,72842,3056,2174102,1163600
4553,162,168,72687,3043,2174270,1378800
4554,163,182,72523,3025,2174452,1298200
4555,169,140,72360,3048,2174592,1152600
4556,155,184,72192,3032,2174776,1242100
4557,139,167,72055,3002,2174943,1297700
4558,170,170,71889,2998,2175113,1169400
4559,153,167,71733,2987,2175280,1207400
4560,165,156,71568,2996,2175436,1223700
4561,174,150,71401,3013,2175586,1253900
4562,160,173,71233,3008,2175759,1236600
4563,170,155,71072,3014,2175914,1177400
4564,127,171,70936,2979,2176085,1283400
4565,147,145,70790,2980,2176230,1423500
4566,159,153,70631,2986,2176383,1286400
4567,144,133,70487,2997,2176516,1311400
4568,147,170,70343,2971,2176686,1185600
4569,150,132,70188,2994,2176818,1232200
4570,144,151,70050,2981,2176969,1253600
4571,160,164,69888,2979,2177133,1070700
4572,161,150,69732,2985,2177283,1228300
4573,150,162,69579,2976,2177445,1178200
4574,149,150,69426,2979,2177595,1165100
4575,169,158,69266,2981,2177753,1186800
4576,154,134,69109,3004,2177887,1374000
4577,159,159,68948,3006,2178046,1353300
4578,140,149,68800,3005,2178195,1210200
4579,138,161,68674,2970,2178356,1240400
4580,170,132,68497,3015,2178488,1119400
4581,155,155,68345,3012,2178643,1202700
4582,164,159,68181,3017,2178802,1238200
4583,170,168,68005,3025,2178970,1413100
4584,155,163,67847,3020,2179133,1296700
4585,152,149,67701,3017,2179282,1315400
4586,161,139,67543,3036,2179421,1358900
4587,148,184,67392,3003,2179605,1270700
4588,190,158,67210,3027,2179763,1180700
4589,166,141,67048,3048,2179904,1191900
4590,176,156,66869,3071,2180060,1185700
4591,152,162,66704,3074,2180222,1234700
4592,172,178,66540,3060,2180400,1213300
4593,165,149,66373,3078,2180549,1230300
4594,177,156,66197,3098,2180705,1137800
4595,172,137,66027,3131,2180842,1134600
4596,154,168,65877,3113,2181010,1288500
4597,142,165,65722,3103,2181175,1208300
4598,166,148,65566,3111,2181323,1274500
4599,121,145,65436,3096,2181468,1168500
4600,156,168,65294,3070,2181636,1149300
4601,173,161,65119,3084,2181797,1211400
4602,152,146,64956,3101,2181943,1161500
4603,145,147,64812,3098,2182090,1167400
4604,134,172,64689,3049,2182262,1401700
4605,148,160,64522,3056,2182422,1350100
4606,154,162,64382,3034,2182584,1271100
4607,147,157,64227,3032,2182741,1250400
4608,143,153,64085,3021,2182894,1342700
4609,146,163,63939,3004,2183057,1238300
4610,127,144,63811,2988,2183201,1438800
4611,140,152,63675,2972,2183353,1207600
4612,121,147,63546,2954,2183500,1157200
4613,135,161,63412,2927,2183661,1128100
4614,154,150,63274,2915,2183811,1290100
4615,138,174,63124,2891,2183985,1166600
4616,141,148,62981,2886,2184133,1137600
4617,160,162,62826,2879,2184295,1376500
4618,139,130,62688,2887,2184425,1276900
4619,154,152,62533,2890,2184577,1272400
4620,131,172,62381,2870,2184749,1259000
4621,136,146,62267,2838,2184895,1154400
4622,152,134,62120,2851,2185029,1209400
4623,112,159,62002,2810,2185188,1272000
4624,113,143,61879,2790,2185331,1254900
4625,123,137,61758,2774,2185468,1282300
4626,138,159,61628,2745,2185627,1191000
4627,124,135,61498,2740,2185762,1363800
4628,132,137,61372,2729,2185899,1197000
4629,129,137,61231,2733,2186036,1379500
4630,114,132,61121,2711,2186168,1172700
4631,116,119,61002,2711,2186287,1327100
4632,123,147,60887,2679,2186434,1164600
4633,90,161,60787,2618,2186595,1295100
4634,106,111,60691,2603,2186706,1243000
4635,110,124,60572,2598,2186830,1345100
4636,131,133,60448,2589,2186963,1264900
4637,124,134,60319,2584,2187097,1273000
4638,124,121,60205,2577,2187218,1355900
4639,99,127,60097,2558,2187345,1279500
4640,132,133,59961,2561,2187478,1353600
4641,127,144,59846,2532,2187622,1265300
4642,120,132,59723,2523,2187754,1219100
4643,153,122,59568,2556,2187876,1252100
4644,122,144,59442,2538,2188020,1217600
4645,125,116,59317,2547,2188136,1145400
4646,146,144,59180,2540,2188280,1190200
4647,125,109,59048,2563,2188389,1349700
4648,113,137,58934,2540,2188526,1468600
4649,126,140,58804,2530,2188666,1254200
4650,124,141,58690,2503,2188807,1362300
4651,107,121,58575,2497,2188928,1360000
4652,133,119,58447,2506,2189047,1352300
4653,130,136,58308,2509,2189183,1483700
4654,113,120,58199,2498,2189303,1244200
4655,109,129,58100,2468,2189432,1305800
4656,141,116,57964,2488,2189548,1233900
4657,132,114,57834,2504,2189662,1170100
4658,117,118,57700,2520,2189780,1272900
4659,120,135,57585,2500,2189915,1232000
4660,108,125,57468,2492,2190040,1444800
4661,108,133,57363,2464,2190173,1317500
4662,119,143,57244,2440,2190316,1407900
4663,112,139,57133,2412,2190455,1338600
4664,139,119,57001,2425,2190574,1280200
4665,129,114,56876,2436,2190688,1381100
4666,137,113,56742,2457,2190801,1360100
4667,117,116,56610,2473,2190917,1292700
4668,130,135,56495,2453,2191052,1186500
4669,130,146,56364,2438,2191198,1239200
4670,117,97,56233,2472,2191295,1127900
4671,114,142,56122,2441,2191437,1153000
4672,94,127,56024,2412,2191564,1133600
4673,118,121,55904,2411,2191685,1173800
4674,106,124,55801,2390,2191809,1586100
4675,118,108,55689,2394,2191917,1272600
4676,124,128,55563,2392,2192045,1124000
4677,108,109,55453,2393,2192154,1237900
4678,93,112,55365,2369,2192266,1200000
4679,125,117,55241,2376,2192383,1329800
4680,119,122,55124,2371,2192505,1300600
4681,126,127,54998,2370,2192632,1327000
4682,118,124,54869,2375,2192756,1167200
4683,131,129,54744,2371,2192885,1195900
4684,112,124,54627,2364,2193009,1287000
4685,111,117,54519,2355,2193126,1225400
4686,121,123,54399,2352,2193249,1202800
4687,110,131,54279,2341,2193380,1262600
4688,101,116,54189,2315,2193496,1082000
4689,101,112,54085,2307,2193608,1021900
4690,130,121,53968,2303,2193729,1179100
4691,95,117,53863,2291,2193846,1217300
4692,105,133,53755,2266,2193979,1207900
4693,102,124,53656,2241,2194103,1265300
4694,85,111,53561,2225,2194214,1218800
4695,101,123,53462,2201,2194337,1238400
4696,108,109,53359,2195,2194446,1190200
4697,90,97,53261,2196,2194543,1115300
4698,98,118,53168,2171,2194661,1185500
4699,93,107,53070,2162,2194768,1202700
4700,92,114,52983,2135,2194882,1175500
4701,93,110,52889,2119,2194992,1214500
4702,99,116,52793,2099,2195108,1348300
4703,99,115,52701,2076,2195223,1239100
4704,94,111,52608,2058,2195334,1206800
4705,98,112,52503,2051,2195446,1155000
4706,100,121,52405,2028,2195567,1402800
4707,94,95,52298,2040,2195662,1333700
4708,95,100,52207,2031,2195762,1312400
4709,99,127,52119,1992,2195889,1161200
4710,110,108,52002,2001,2195997,1164600
4711,100,125,51903,1975,2196122,1236500
4712,110,97,51795,1986,2196219,1138600
4713,102,90,51690,2001,2196309,1059800
4714,96,110,51592,1989,2196419,1154200
4715,107,100,51498,1983,2196519,1229700
4716,122,100,51379,2002,2196619,1217800
4717,103,90,51266,2025,2196709,1218800
4718,108,118,51157,2016,2196827,1136300
4719,114,85,51046,2042,2196912,1115300
4720,98,96,50949,2043,2197008,1119500
4721,103,106,50839,2047,2197114,1200400
4722,89,104,50745,2037,2197218,1162500
4723,96,95,50661,2026,2197313,1191200
4724,107,105,50548,2034,2197418,1220300
4725,104,113,50444,2025,2197531,1212600
4726,92,106,50352,2011,2197637,1360800
4727,101,90,50249,2024,2197727,1284600
4728,90,100,50164,2009,2197827,1299800
4729,80,90,50077,2006,2197917,1251300
4730,87,100,49992,1991,2198017,1301900
4731,103,109,49889,1985,2198126,1161400
4732,92,102,49798,1974,2198228,1256700
4733,75,110,49719,1943,2198338,1066400
4734,74,101,49649,1912,2198439,1154800
4735,85,114,49559,1888,2198553,1191300
4736,70,95,49487,1865,2198648,1118400
4737,91,70,49397,1885,2198718,1166100
4738,65,82,49337,1863,2198800,1096900
4739,96,87,49244,1869,2198887,1095500
4740,92,94,49153,1866,2198981,1024000
4741,86,113,49058,1848,2199094,1103900
4742,90,81,48969,1856,2199175,1060800
4743,89,86,48880,1859,2199261,1130000
4744,87,98,48791,1850,2199359,1106700
4745,83,77,48709,1855,2199436,1172200
4746,74,76,48640,1848,2199512,1165200
4747,82,109,48555,1824,2199621,1281200
4748,85,95,48470,1814,2199716,1152500
4749,84,98,48383,1803,2199814,1143400
4750,85,91,48300,1795,2199905,1219100
4751,84,86,48220,1789,2199991,1054800
4752,95,97,48130,1782,2200088,1147400
4753,73,79,48042,1791,2200167,1144700
4754,97,95,47952,1786,2200262,1151600
4755,95,102,47861,1775,2200364,1055700
4756,80,99,47780,1757,2200463,1123600
4757,78,83,47700,1754,2200546,1024400
4758,99,85,47606,1763,2200631,1093900
4759,93,90,47506,1773,2200721,1011700
4760,77,94,47434,1751,2200815,1126100
4761,80,87,47353,1745,2200902,1225700
4762,92,88,47261,1749,2200990,1127400
4763,86,77,47176,1757,2201067,1211400
4764,74,102,47095,1736,2201169,1087300
4765,87,85,47012,1734,2201254,1060200
4766,65,95,46941,1710,2201349,1154100
4767,74,80,46866,1705,2201429,1207100
4768,79,73,46795,1703,2201502,1131400
4769,83,85,46705,1708,2201587,1108600
4770,75,97,46632,1684,2201684,1071400
4771,61,102,46576,1638,2201786,1108600
4772,67,78,46501,1635,2201864,1269000
4773,78,75,46425,1636,2201939,1137200
4774,66,94,46362,1605,2202033,1135100
4775,59,80,46302,1585,2202113,1059300
4776,66,97,46234,1556,2202210,1122700
4777,71,75,46163,1552,2202285,1145000
4778,64,85,46099,1531,2202370,1158700
4779,60,68,46045,1517,2202438,1084600
4780,66,82,45975,1505,2202520,1114700
4781,67,71,45908,1501,2202591,1134900
4782,58,74,45847,1488,2202665,1146400
4783,78,80,45774,1481,2202745,1123600
4784,69,68,45704,1483,2202813,1259300
4785,65,90,45635,1462,2202903,1231100
4786,59,73,45580,1444,2202976,1207100
4787,46,64,45525,1435,2203040,1426000
4788,57,89,45478,1393,2203129,1406900
4789,46,71,45420,1380,2203200,1342100
4790,55,58,45374,1368,2203258,1341400
4791,67,67,45306,1369,2203325,1845000
4792,59,59,45242,1374,2203384,1320400
4793,53,76,45198,1342,2203460,1332600
4794,64,60,45131,1349,2203520,1261300
4795,62,71,45070,1339,2203591,1184600
4796,59,61,45010,1338,2203652,1246300
4797,58,60,44950,1338,2203712,1127900
4798,65,77,44888,1323,2203789,1125100
4799,52,73,44829,1309,2203862,1317300
4800,55,76,44782,1280,2203938,1270500
4801,59,73,44717,1272,2204011,1137100
4802,77,73,44644,1272,2204084,1228100
4803,57,80,44585,1251,2204164,1185100
4804,64,62,44526,1248,2204226,1211200
4805,64,71,44457,1246,2204297,1096300
4806,54,68,44407,1228,2204365,1096000
4807,55,53,44352,1230,2204418,1135900
4808,61,72,44284,1226,2204490,1053500
4809,66,58,44226,1226,2204548,1083700
4810,70,58,44153,1241,2204606,1151500
4811,41,49,44110,1235,2204655,1208800
4812,60,68,44052,1225,2204723,1256200
4813,52,35,44000,1242,2204758,1270800
4814,62,61,43934,1247,2204819,1231200
4815,52,69,43881,1231,2204888,1293800
4816,63,55,43826,1231,2204943,1230700
4817,70,59,43753,1245,2205002,1189400
4818,65,63,43692,1243,2205065,1203300
4819,64,80,43626,1229,2205145,1161900
4820,72,68,43549,1238,2205213,1301800
4821,60,59,43488,1240,2205272,1152200
4822,57,67,43431,1230,2205339,1081500
4823,63,63,43375,1223,2205402,1039100
4824,62,64,43306,1228,2205466,986900
4825,51,65,43254,1215,2205531,1006300
4826,78,49,43181,1239,2205580,1044100
4827,51,55,43128,1237,2205635,1043100
4828,66,60,43065,1240,2205695,1036200
4829,50,59,43012,1234,2205754,1026100
4830,65,56,42955,1235,2205810,1093600
4831,62,64,42890,1236,2205874,1061000
4832,57,57,42830,1239,2205931,1047800
4833,55,64,42771,1234,2205995,1037500
4834,62,47,42718,1240,2206042,1114900
4835,59,77,42655,1226,2206119,1110000
4836,44,63,42604,1214,2206182,1062400
4837,59,72,42548,1198,2206254,1104500
4838,51,75,42497,1174,2206329,1048700
4839,35,55,42463,1153,2206384,1178700
4840,65,53,42400,1163,2206437,1061900
4841,58,75,42339,1149,2206512,1174100
4842,41,61,42293,1134,2206573,1184000
4843,58,58,42241,1128,2206631,1165200
4844,44,55,42193,1121,2206686,1141700
4845,41,62,42149,1103,2206748,1097100
4846,39,40,42114,1098,2206788,1065100
4847,51,53,42063,1096,2206841,1033100
4848,42,62,42025,1072,2206903,1144700
4849,35,61,41985,1051,2206964,1229700
4850,46,48,41942,1046,2207012,1038400
4851,38,64,41902,1022,2207076,1002200
4852,41,54,41860,1010,2207130,1034200
4853,47,52,41813,1005,2207182,987800
4854,53,57,41765,996,2207239,1007400
4855,50,55,41712,994,2207294,1000400
4856,45,42,41664,1000,2207336,1010500
4857,37,43,41630,991,2207379,1019600
4858,54,41,41581,999,2207420,978500
4859,36,40,41539,1001,2207460,1052300
4860,49,62,41491,987,2207522,1030900
4861,54,51,41440,987,2207573,994100
4862,48,54,41388,985,2207627,1084000
4863,41,42,41348,983,2207669,1032500
4864,52,43,41300,988,2207712,1073700
4865,42,43,41253,992,2207755,1049300
4866,41,58,41213,974,2207813,1003300
4867,29,56,41181,950,2207869,1079200
4868,37,57,41145,929,2207926,1006900
4869,42,41,41105,928,2207967,981600
4870,41,49,41060,924,2208016,1037800
4871,34,49,41029,906,2208065,991600
4872,31,56,40996,883,2208121,1018400
4873,33,40,40966,873,2208161,1070200
4874,38,52,40929,858,2208213,1048600
4875,35,42,40891,854,2208255,1061900
4876,38,38,40849,858,2208293,1029200
4877,37,54,40815,838,2208347,1033600
4878,41,35,40774,844,2208382,1046500
4879,34,38,40741,839,2208420,1029000
4880,42,33,40701,846,2208453,1014800
4881,35,37,40666,844,2208490,999600
4882,48,42,40620,848,2208532,1024600
4883,40,42,40575,851,2208574,1000800
4884,28,49,40545,832,2208623,956000
4885,29,46,40518,813,2208669,1036600
4886,30,33,40490,808,2208702,1049200
4887,37,35,40453,810,2208737,1054000
4888,45,46,40414,803,2208783,1110400
4889,29,39,40380,798,2208822,1027500
4890,34,49,40345,784,2208871,1006800
4891,44,47,40302,780,2208918,1100100
4892,27,38,40270,774,2208956,1166000
4893,38,38,40239,767,2208994,1108800
4894,28,48,40210,748,2209042,1071100
4895,40,40,40170,748,2209082,1103700
4896,29,41,40136,741,2209123,1046100
4897,30,44,40105,728,2209167,1067300
4898,27,30,40076,727,2209197,1070800
4899,29,41,40051,711,2209238,989800
4900,29,43,40021,698,2209281,1066200
4901,24,36,39996,687,2209317,1093500
4902,26,31,39970,682,2209348,1024900
4903,36,43,39938,671,2209391,1009300
4904,36,39,39899,671,2209430,1088400
4905,28,34,39870,666,2209464,1213100
4906,29,43,39848,645,2209507,1187000
4907,32,31,39811,651,2209538,1322100
4908,25,21,39787,654,2209559,1157200
4909,24,35,39759,647,2209594,1134200
4910,27,25,39735,646,2209619,1120000
4911,36,28,39700,653,2209647,1067900
4912,24,40,39672,641,2209687,1076000
4913,26,38,39652,623,2209725,1060000
4914,36,29,39614,632,2209754,1016000
4915,39,26,39577,643,2209780,1017600
4916,19,34,39552,634,2209814,1051200
4917,27,16,39528,642,2209830,1078700
4918,34,48,39496,626,2209878,1060900
4919,30,43,39465,614,2209921,1052000
4920,31,31,39436,612,2209952,1054700
4921,31,32,39400,616,2209984,1086400
4922,28,31,39379,606,2210015,1049900
4923,30,32,39342,611,2210047,1100300
4924,21,43,39320,590,2210090,1217500
4925,22,32,39301,577,2210122,1043000
4926,27,28,39274,576,2210150,1018800
4927,25,28,39248,574,2210178,1019000
4928,24,31,39224,567,2210209,1110600
4929,32,30,39197,564,2210239,1080800
4930,30,18,39164,579,2210257,1012300
4931,24,16,39138,589,2210273,993500
4932,21,33,39115,579,2210306,1046000
4933,33,34,39088,572,2210340,1026000
4934,33,27,39053,580,2210367,964300
4935,19,34,39032,567,2210401,1013800
4936,32,31,39000,568,2210432,1115000
4937,26,29,38972,567,2210461,1380500
4938,20,23,38957,559,2210484,1121600
4939,24,28,38931,557,2210512,1084500
4940,27,29,38902,557,2210541,1029700
4941,17,32,38888,539,2210573,1114500
4942,29,33,38858,536,2210606,1022800
4943,19,24,38836,534,2210630,2909200
4944,13,22,38824,524,2210652,1126400
4945,26,26,38800,522,2210678,1035300
4946,29,18,38772,532,2210696,1070700
4947,28,30,38743,531,2210726,1052800
4948,28,25,38712,537,2210751,1056200
4949,29,22,38684,543,2210773,1187800
4950,22,29,38661,537,2210802,1127500
4951,25,17,38636,545,2210819,1136500
4952,15,32,38621,528,2210851,1036000
4953,19,33,38602,514,2210884,1045600
4954,24,22,38582,512,2210906,1036900
4955,19,31,38562,501,2210937,1047700
4956,20,31,38539,493,2210968,1041300
4957,23,19,38519,494,2210987,1055500
4958,20,21,38495,497,2211008,1078200
4959,27,22,38469,501,2211030,1103500
4960,16,25,38454,491,2211055,1267900
4961,23,25,38431,489,2211080,1042400
4962,22,23,38409,488,2211103,1054700
4963,15,23,38394,480,2211126,1154100
4964,25,22,38369,483,2211148,1141800
4965,20,29,38349,474,2211177,1182000
4966,22,22,38326,475,2211199,1143000
4967,13,37,38315,449,2211236,1125100
4968,19,31,38297,436,2211267,1030400
4969,23,26,38274,433,2211293,1093100
4970,26,17,38246,444,2211310,1103500
4971,21,23,38224,443,2211333,1246500
4972,10,22,38216,429,2211355,1079700
4973,14,24,38201,420,2211379,1056400
4974,19,24,38180,417,2211403,1019900
4975,14,10,38170,417,2211413,986400
4976,16,23,38155,409,2211436,1087600
4977,22,21,38131,412,2211457,1003100
4978,22,20,38109,414,2211477,1015900
4979,26,22,38085,416,2211499,1049400
4980,17,14,38067,420,2211513,996800
4981,19,18,38046,423,2211531,995800
4982,14,19,38030,420,2211550,1046100
4983,14,26,38015,409,2211576,987700
4984,18,16,38001,407,2211592,998400
4985,30,15,37973,420,2211607,1044200
4986,11,24,37957,412,2211631,988800
4987,26,20,37934,415,2211651,1002000
4988,19,14,37912,423,2211665,1040000
4989,29,21,37885,429,2211686,1026900
4990,15,22,37871,421,2211708,996200
4991,26,14,37845,433,2211722,1016400
4992,26,25,37823,430,2211747,1099700
4993,26,22,37792,439,2211769,1065200
4994,25,21,37770,440,2211790,1016800
4995,25,19,37745,446,2211809,1024100
4996,35,22,37714,455,2211831,980700
4997,32,20,37681,468,2211851,1018700
4998,33,28,37643,478,2211879,962000
4999,24,33,37619,469,2211912,1012300
5000,17,27,37600,461,2211939,1015200
5001,27,30,37573,458,2211969,1041200
5002,32,23,37544,464,2211992,1035900
5003,18,23,37526,459,2212015,1020300
5004,29,27,37499,459,2212042,976900
5005,17,16,37476,466,2212058,1051500
5006,31,17,37452,473,2212075,973600
5007,20,27,37426,472,2212102,964700
5008,31,29,37400,469,2212131,1033300
5009,25,24,37373,472,2212155,1027400
5010,34,21,37338,486,2212176,980900
5011,32,26,37307,491,2212202,1051600
5012,23,27,37284,487,2212229,993300
5013,22,24,37260,487,2212253,999000
5014,31,28,37231,488,2212281,1018400
5015,25,21,37204,494,2212302,1076800
5016,21,26,37182,490,2212328,1014100
5017,13,22,37168,482,2212350,1034200
5018,22,25,37147,478,2212375,1011300
5019,20,27,37129,469,2212402,984100
5020,28,27,37103,468,2212429,1006700
5021,20,15,37081,475,2212444,997400
5022,18,30,37062,464,2212474,1005000
5023,23,32,37040,454,2212506,1001900
5024,28,24,37015,455,2212530,1096100
5025,22,21,36990,459,2212551,1055700
5026,21,28,36967,454,2212579,1051800
5027,17,24,36951,446,2212603,1078000
5028,15,31,36937,429,2212634,1083200
5029,22,24,36912,430,2212658,1081400
5030,10,16,36903,423,2212674,1104200
5031,23,19,36879,428,2212693,1034500
5032,16,22,36863,422,2212715,1056300
5033,24,19,36841,425,2212734,1011900
5034,17,17,36825,424,2212751,1032100
5035,12,24,36809,416,2212775,1014300
5036,14,19,36799,407,2212794,1029100
5037,14,13,36781,412,2212807,1008400
5038,15,33,36768,392,2212840,1036100
5039,14,24,36756,380,2212864,997600
5040,17,14,36738,384,2212878,1003700
5041,8,21,36728,373,2212899,1037000
5042,15,12,36713,376,2212911,987200
5043,10,23,36702,364,2212934,1024700
5044,11,21,36694,351,2212955,1024700
5045,13,24,36680,341,2212979,1067700
5046,11,19,36668,334,2212998,1033700
5047,9,16,36660,326,2213014,974800
5048,18,18,36642,326,2213032,989100
5049,14,24,36628,316,2213056,1017300
5050,17,11,36612,321,2213067,946200
5051,16,12,36595,326,2213079,1073100
5052,12,12,36585,324,2213091,1027900
5053,8,16,36573,320,2213107,1049700
5054,19,20,36557,316,2213127,1110800
5055,14,23,36542,308,2213150,1113500
5056,16,16,36527,307,2213166,1053900
5057,15,16,36513,305,2213182,1112700
5058,11,18,36499,301,2213200,1084600
5059,17,18,36485,297,2213218,1032800
5060,9,18,36473,291,2213236,1029800
5061,11,20,36463,281,2213256,1059200
5062,10,15,36452,277,2213271,1049600
5063,19,13,36435,281,2213284,1023500
5064,12,12,36421,283,2213296,1011500
5065,15,13,36409,282,2213309,1012300
5066,18,10,36389,292,2213319,1050600
5067,14,9,36376,296,2213328,995900
5068,6,16,36368,288,2213344,1011200
5069,14,18,36354,284,2213362,1132200
5070,13,16,36344,278,2213378,1046200
5071,11,16,36329,277,2213394,1029500
5072,17,9,36313,284,2213403,999100
5073,15,15,36297,285,2213418,1079100
5074,18,17,36283,282,2213435,1057800
5075,15,14,36267,284,2213449,1038000
5076,11,13,36255,283,2213462,1106800
5077,14,14,36240,284,2213476,1014300
5078,22,12,36218,294,2213488,1043700
5079,17,16,36202,294,2213504,1060600
5080,12,14,36190,292,2213518,994800
5081,10,15,36179,288,2213533,1057300
5082,14,13,36168,286,2213546,1069400
5083,4,17,36160,277,2213563,1109700
5084,18,13,36144,280,2213576,1052100
5085,12,11,36132,281,2213587,1081300
5086,12,25,36118,270,2213612,1073800
5087,8,14,36111,263,2213626,983200
5088,6,17,36106,251,2213643,1055900
5089,12,10,36093,254,2213653,1136000
5090,11,9,36084,254,2213662,1158700
5091,14,10,36068,260,2213672,1195900
5092,12,16,36057,255,2213688,1074000
5093,9,14,36046,252,2213702,1077600
5094,8,17,36040,241,2213719,1059600
5095,8,14,36031,236,2213733,1139100
5096,10,12,36022,233,2213745,1041800
5097,12,11,36012,232,2213756,1023400
5098,8,13,36000,231,2213769,1135100
5099,7,13,35993,225,2213782,1071400
5100,11,17,35986,215,2213799,1092700
5101,10,8,35974,219,2213807,1082900
5102,8,11,35965,217,2213818,1037600
5103,8,15,35959,208,2213833,1060700
5104,7,12,35950,205,2213845,1008800
5105,9,15,35940,200,2213860,1022700
5106,10,11,35932,197,2213871,996200
5107,7,12,35923,194,2213883,1098000
5108,9,11,35915,191,2213894,984700
5109,9,8,35908,190,2213902,1045800
5110,11,14,35895,189,2213916,1018900
5111,9,8,35886,190,2213924,1038300
5112,8,8,35877,191,2213932,934100
5113,14,12,35863,193,2213944,1091200
5114,14,6,35850,200,2213950,1063800
5115,17,12,35836,202,2213962,1057100
5116,11,7,35822,209,2213969,1031700
5117,12,13,35812,206,2213982,1068300
5118,9,13,35801,204,2213995,1093100
5119,12,17,35790,198,2214012,1138600
5120,15,7,35775,206,2214019,1150800
5121,10,11,35765,205,2214030,1107100
5122,18,8,35747,215,2214038,1022600
5123,17,17,35729,216,2214055,1000700
5124,6,14,35722,209,2214069,1089300
5125,14,12,35711,208,2214081,1048900
5126,12,14,35697,208,2214095,1029800
5127,7,11,35690,204,2214106,1088300
5128,11,12,35680,202,2214118,1081500
5129,12,9,35668,205,2214127,1040500
5130,8,13,35660,200,2214140,1055300
5131,7,14,35651,195,2214154,1081400
5132,9,9,35643,194,2214163,1051000
5133,7,14,35635,188,2214177,1138700
5134,11,9,35627,187,2214186,1221500
5135,9,6,35617,191,2214192,1073500
5136,7,6,35608,194,2214198,1046400
5137,7,6,35603,193,2214204,1086000
5138,15,7,35588,201,2214211,1068000
5139,13,10,35575,204,2214221,1028600
5140,8,11,35566,202,2214232,988700
5141,12,21,35553,194,2214253,1097400
5142,10,14,35543,190,2214267,1102400
5143,10,9,35533,191,2214276,1384000
5144,8,7,35526,191,2214283,1286900
5145,9,6,35516,195,2214289,1280500
5146,1,13,35515,183,2214302,1227700
5147,9,8,35507,183,2214310,1302400
5148,7,11,35499,180,2214321,1301400
5149,10,6,35491,182,2214327,1131300
5150,10,7,35483,183,2214334,1105200
5151,12,6,35468,192,2214340,1125000
5152,12,10,35457,193,2214350,1191200
5153,9,15,35449,186,2214365,1319000
5154,15,7,35434,194,2214372,1266100
5155,8,10,35426,192,2214382,1262400
5156,13,9,35415,194,2214391,1185200
5157,11,10,35401,198,2214401,1279100
5158,13,11,35388,200,2214412,1479500
5159,15,8,35374,206,2214420,1142600
5160,14,17,35359,204,2214437,1234600
5161,19,18,35342,203,2214455,1509300
5162,13,14,35327,204,2214469,1339300
5163,20,9,35307,215,2214478,1356700
5164,11,15,35295,212,2214493,1173400
5165,12,9,35285,213,2214502,1247200
5166,9,8,35274,216,2214510,1325400
5167,12,8,35263,219,2214518,1263600
5168,8,10,35254,218,2214528,1303900
5169,12,11,35243,218,2214539,1284300
5170,12,10,35232,219,2214549,1189100
5171,7,10,35222,219,2214559,1136800
5172,8,12,35219,210,2214571,1080300
5173,8,19,35207,203,2214590,1050100
5174,10,16,35198,196,2214606,1109200
5175,5,6,35192,196,2214612,1112200
5176,13,14,35179,195,2214626,1052600
5177,7,12,35175,187,2214638,1069500
5178,14,17,35158,187,2214655,1106500
5179,9,11,35151,183,2214666,1234300
5180,12,8,35139,187,2214674,1136800
5181,9,7,35127,192,2214681,1108000
5182,13,12,35117,190,2214693,1263900
5183,10,10,35106,191,2214703,1159700
5184,6,7,35098,192,2214710,1165000
5185,11,9,35090,191,2214719,1145600
5186,12,7,35075,199,2214726,1111700
5187,11,13,35066,195,2214739,1141400
5188,15,8,35052,201,2214747,1161800
5189,10,9,35041,203,2214756,1382500
5190,14,8,35028,208,2214764,1356100
5191,5,10,35020,206,2214774,1488900
5192,7,5,35014,207,2214779,1596300
5193,8,16,35006,199,2214795,1376200
5194,9,13,34997,195,2214808,1350400
5195,8,9,34990,193,2214817,1305000
5196,8,13,34982,188,2214830,1230600
5197,6,7,34975,188,2214837,1250800
5198,9,12,34967,184,2214849,1233500
5199,6,7,34961,183,2214856,1510600
5200,13,14,34949,181,2214870,1371400
5201,14,6,34933,191,2214876,1221300
5202,9,5,34924,195,2214881,1398100
5203,9,8,34915,196,2214889,1342900
5204,12,7,34905,199,2214896,1298800
5205,9,7,34896,201,2214903,1170400
5206,14,5,34882,210,2214908,1161200
5207,17,11,34864,217,2214919,1133900
5208,9,15,34854,212,2214934,1290300
5209,10,7,34846,213,2214941,1266200
5210,6,9,34841,209,2214950,1353300
5211,15,11,34824,215,2214961,1178900
5212,7,11,34817,211,2214972,1191400
5213,11,5,34805,218,2214977,1249400
5214,5,10,34800,213,2214987,1109300
5215,16,6,34786,221,2214993,1196700
5216,7,9,34776,222,2215002,1110900
5217,9,22,34768,208,2215024,1197700
5218,8,12,34760,204,2215036,1141400
5219,7,6,34754,204,2215042,1059400
5220,7,7,34746,205,2215049,1274700
5221,5,10,34742,199,2215059,1327700
5222,5,11,34735,195,2215070,1252000
5223,8,9,34728,193,2215079,1272500
5224,7,6,34721,194,2215085,1318800
5225,4,12,34716,187,2215097,1305900
5226,7,9,34710,184,2215106,1208300
5227,8,8,34702,184,2215114,1287400
5228,1,9,34700,177,2215123,1198800
5229,9,7,34693,177,2215130,1262800
5230,4,15,34688,167,2215145,1253900
5231,2,7,34685,163,2215152,1135100
5232,1,9,34684,155,2215161,1188800
5233,5,6,34680,153,2215167,1117700
5234,0,6,34679,148,2215173,1052200
5235,4,6,34675,146,2215179,994900
5236,3,10,34672,139,2215189,1001400
5237,4,9,34668,134,2215198,1078000
5238,1,3,34667,132,2215201,1128300
5239,9,5,34660,134,2215206,1060800
5240,3,4,34655,135,2215210,1031100
5241,1,8,34654,128,2215218,1082900
5242,0,11,34654,117,2215229,1172600
5243,4,7,34651,113,2215236,1139000
5244,2,2,34648,114,2215238,1052400
5245,2,8,34646,108,2215246,1094900
5246,1,5,34645,104,2215251,1033700
5247,2,5,34643,101,2215256,1223200
5248,4,5,34639,100,2215261,1045300
5249,1,7,34638,94,2215268,1158500
5250,1,3,34637,92,2215271,1049400
5251,3,6,34635,88,2215277,970300
5252,1,3,34633,87,2215280,1015600
5253,0,10,34633,77,2215290,1051900
5254,1,2,34633,75,2215292,974600
5255,3,2,34630,76,2215294,1025000
5256,2,4,34628,74,2215298,1006100
5257,0,7,34627,68,2215305,1047900
5258,0,1,34627,67,2215306,1098200
5259,1,0,34627,67,2215306,1045300
5260,1,1,34625,68,2215307,1028000
5261,1,3,34624,66,2215310,1103400
5262,1,6,34623,61,2215316,1075900
5263,3,1,34620,63,2215317,1084300
5264,0,3,34620,60,2215320,1082500
5265,2,2,34618,60,2215322,1037800
5266,0,9,34618,51,2215331,991900
5267,0,1,34618,50,2215332,1001200
5268,0,0,34618,50,2215332,1128000
5269,0,2,34618,48,2215334,1024300
5270,0,3,34618,45,2215337,1228100
5271,0,0,34618,45,2215337,1199700
5272,0,1,34618,44,2215338,1103500
5273,1,4,34618,40,2215342,1064900
5274,0,3,34617,38,2215345,1097800
5275,0,2,34617,36,2215347,1007200
5276,0,0,34617,36,2215347,1000100
5277,0,2,34617,34,2215349,1176500
5278,0,1,34617,33,2215350,1062500
5279,1,2,34616,32,2215352,1054800
5280,0,1,34616,31,2215353,1109100
5281,0,0,34616,31,2215353,1045300
5282,0,0,34616,31,2215353,1240700
5283,0,1,34616,30,2215354,1172200
5284,1,2,34616,28,2215356,1322200
5285,1,1,34615,28,2215357,1199300
5286,0,1,34614,28,2215358,1058900
5287,0,0,34614,28,2215358,1526500
5288,0,1,34614,27,2215359,1149200
5289,1,2,34613,26,2215361,1173500
5290,0,1,34613,25,2215362,1978300
5291,0,0,34613,25,2215362,1077600
5292,1,1,34613,24,2215363,1066200
5293,1,0,34611,26,2215363,1054700
5294,0,0,34611,26,2215363,1061400
5295,1,1,34611,25,2215364,1134600
5296,0,0,34610,26,2215364,1258400
5297,0,5,34610,21,2215369,1088500
5298,0,0,34610,21,2215369,1140100
5299,1,0,34609,22,2215369,1031300
5300,0,1,34609,21,2215370,1413500
5301,0,2,34609,19,2215372,1060100
5302,0,0,34609,19,2215372,1022800
5303,0,1,34609,18,2215373,971900
5304,0,0,34609,18,2215373,1036600
5305,0,0,34609,18,2215373,1402300
5306,0,3,34609,15,2215376,1199500
5307,0,1,34609,14,2215377,1316800
5308,0,0,34609,14,2215377,1055000
5309,0,1,34609,13,2215378,1641700
5310,0,1,34609,12,2215379,1564000
5311,0,0,34609,12,2215379,1219200
5312,0,2,34609,10,2215381,1277500
5313,0,0,34609,10,2215381,1156900
5314,0,2,34609,8,2215383,1201500
5315,0,0,34609,8,2215383,1267500
5316,0,1,34609,7,2215384,1237800
5317,0,0,34609,7,2215384,1592000
5318,0,0,34609,7,2215384,1189800
5319,0,0,34609,7,2215384,1146000
5320,0,0,34609,7,2215384,1274100
5321,0,0,34609,7,2215384,1136800
5322,0,2,34609,5,2215386,1149500
5323,0,0,34609,5,2215386,1409200
5324,0,0,34609,5,2215386,1162300
5325,0,0,34609,5,2215386,1158700
5326,0,0,34609,5,2215386,1715100
5327,0,0,34609,5,2215386,1554100
5328,0,0,34609,5,2215386,1102400
5329,0,0,34609,5,2215386,1159300
5330,0,1,34609,4,2215387,1168100
5331,0,0,34609,4,2215387,1066000
5332,0,0,34609,4,2215387,1109600
5333,0,0,34609,4,2215387,1026100
5334,0,0,34609,4,2215387,1162400
5335,0,0,34609,4,2215387,1032500
5336,0,0,34609,4,2215387,1089400
5337,0,0,34609,4,2215387,1056900
5338,0,0,34609,4,2215387,991300
5339,0,1,34609,3,2215388,1004600
5340,0,0,34609,3,2215388,1049200
5341,0,1,34609,2,2215389,1053400
5342,0,0,34609,2,2215389,1166000
5343,0,0,34609,2,2215389,1092400
5344,0,0,34609,2,2215389,1069600
5345,0,0,34609,2,2215389,1025500
5346,0,0,34609,2,2215389,1057900
5347,0,0,34609,2,2215389,1033700
5348,0,0,34609,2,2215389,1013100
5349,0,0,34609,2,2215389,1049900
5350,0,0,34609,2,2215389,1039600
5351,0,0,34609,2,2215389,1016100
5352,0,0,34609,2,2215389,1017200
5353,0,0,34609,2,2215389,987500
5354,0,0,34609,2,2215389,1019300
5355,0,0,34609,2,2215389,1088900
5356,0,0,34609,2,2215389,1336400
5357,0,0,34609,2,2215389,1128200
5358,0,0,34609,2,2215389,1089500
5359,0,0,34609,2,2215389,1113700
5360,0,0,34609,2,2215389,1473400
5361,0,0,34609,2,2215389,1069200
5362,0,0,34609,2,2215389,1069400
5363,0,0,34609,2,2215389,1299200
5364,0,0,34609,2,2215389,1108800
5365,0,0,34609,2,2215389,1097600
5366,0,0,34609,2,2215389,1085400
5367,0,0,34609,2,2215389,1196900
5368,0,0,34609,2,2215389,1044500
5369,0,0,34609,2,2215389,1064000
5370,0,0,34609,2,2215389,1182500
5371,0,1,34609,1,2215390,1119900
5372,0,0,34609,1,2215390,1233100
5373,0,0,34609,1,2215390,1120400
5374,0,0,34609,1,2215390,1045400
5375,0,0,34609,1,2215390,1254500
5376,0,0,34609,1,2215390,1359300
5377,0,0,34609,1,2215390,1301500
5378,0,0,34609,1,2215390,1146800
5379,0,1,34609,0,2215391,1112100
