Tick,NewlyInfected,NewlyRecovered,TotalSusceptible,TotalInfected,TotalRecovered,StepTimeNanos
0,3,0,2249992,8,0,2154100
1,3,0,2249992,8,0,1393700
2,4,1,2249985,14,1,1222000
3,2,0,2249983,16,1,1195500
4,4,0,2249981,18,1,1047200
5,4,0,2249975,24,1,1104000
6,9,1,2249967,31,2,1071000
7,9,2,2249960,36,4,1113800
8,9,2,2249953,41,6,1039600
9,13,3,2249938,53,9,979400
10,9,6,2249928,57,15,1198900
11,12,5,2249919,61,20,1019400
12,7,4,2249909,67,24,1082100
13,5,3,2249903,70,27,1087700
14,11,6,2249893,74,33,1026400
15,12,2,2249886,79,35,1011400
16,10,5,2249871,89,40,983800
17,12,5,2249858,97,45,1023300
18,12,10,2249847,98,55,1112900
19,9,5,2249839,101,60,1107300
20,7,2,2249832,106,62,1107000
21,12,6,2249824,108,68,1155300
22,11,6,2249808,118,74,1026700
23,21,7,2249793,126,81,1129300
24,15,11,2249773,135,92,1029600
25,21,11,2249756,141,103,1037900
26,13,9,2249740,148,112,1221500
27,20,8,2249721,159,120,1021600
28,20,8,2249705,167,128,977900
29,20,8,2249680,184,136,975600
30,24,13,2249658,193,149,994500
31,17,8,2249640,203,157,1040900
32,21,12,2249617,214,169,1059600
33,21,11,2249598,222,180,1015500
34,32,9,2249568,243,189,1033700
35,31,18,2249535,258,207,1211800
36,30,12,2249504,277,219,1088100
37,29,23,2249473,285,242,1094000
38,22,16,2249450,292,258,1119300
39,14,14,2249440,288,272,1191400
40,23,18,2249417,293,290,1078100
41,30,15,2249395,300,305,1071100
42,33,16,2249356,323,321,1078500
43,34,23,2249322,334,344,1039700
44,37,14,2249284,358,358,1078400
45,37,23,2249246,373,381,1022700
46,31,20,2249216,383,401,1063900
47,38,21,2249181,397,422,1146900
48,41,25,2249136,417,447,1019800
49,26,26,2249112,415,473,1032700
50,36,15,2249077,435,488,1039900
51,39,17,2249037,458,505,1056800
52,42,29,2249000,466,534,1170400
53,59,21,2248946,499,555,1072700
54,54,30,2248884,531,585,1029700
55,33,22,2248853,540,607,1037700
56,54,28,2248797,568,635,1015400
57,46,32,2248751,582,667,1036000
58,32,27,2248716,590,694,1028200
59,49,24,2248672,610,718,1043100
60,53,22,2248619,641,740,1018200
61,64,28,2248555,677,768,1067100
62,58,34,2248499,699,802,1099600
63,70,42,2248430,726,844,1069500
64,57,34,2248369,753,878,1020500
65,60,32,2248314,776,910,1123700
66,55,38,2248258,794,948,1316200
67,77,41,2248188,823,989,1289100
68,50,35,2248127,849,1024,1323300
69,100,40,2248042,894,1064,1534900
70,84,50,2247955,931,1114,999700
71,50,51,2247900,935,1165,942300
72,45,58,2247846,931,1223,919700
73,57,36,2247794,947,1259,910500
74,59,52,2247737,952,1311,942300
75,62,48,2247670,971,1359,953300
76,77,46,2247597,998,1405,953700
77,64,42,2247534,1019,1447,893100
78,73,46,2247460,1047,1493,901300
79,75,62,2247386,1059,1555,920600
80,60,63,2247321,1061,1618,966400
81,84,46,2247242,1094,1664,945900
82,75,69,2247164,1103,1733,1042500
83,89,63,2247079,1125,1796,962700
84,66,55,2247018,1131,1851,959300
85,72,55,2246942,1152,1906,949600
86,87,64,2246857,1173,1970,1009900
87,73,71,2246779,1180,2041,1278800
88,80,60,2246706,1193,2101,1008300
89,88,76,2246622,1201,2177,946400
90,83,57,2246535,1231,2234,1075600
91,69,66,2246462,1238,2300,1073300
92,69,56,2246393,1251,2356,1052000
93,85,64,2246313,1267,2420,983800
94,56,70,2246253,1257,2490,950500
95,87,62,2246166,1282,2552,884600
96,78,78,2246090,1280,2630,908700
97,76,75,2246009,1286,2705,916000
98,70,66,2245943,1286,2771,962100
99,103,59,2245845,1325,2830,940800
100,97,73,2245743,1354,2903,925500
101,89,66,2245652,1379,2969,929100
102,101,73,2245558,1400,3042,913100
103,86,74,2245468,1416,3116,892900
104,109,58,2245370,1456,3174,933400
105,90,93,2245268,1465,3267,925200
106,92,74,2245175,1484,3341,963800
107,109,76,2245066,1517,3417,972600
108,117,91,2244944,1548,3508,930000
109,92,74,2244857,1561,3582,929300
110,89,84,2244771,1563,3666,895000
111,94,84,2244686,1564,3750,905800
112,95,100,2244578,1572,3850,899400
113,83,99,2244498,1553,3949,894700
114,102,93,2244407,1551,4042,928000
115,103,78,2244292,1588,4120,954800
116,110,86,2244187,1607,4206,905700
117,81,96,2244106,1592,4302,1086300
118,95,84,2244013,1601,4386,948200
119,109,80,2243895,1639,4466,917500
120,81,70,2243816,1648,4536,919200
121,109,93,2243707,1664,4629,910500
122,100,72,2243615,1684,4701,940100
123,97,81,2243511,1707,4782,1014400
124,121,97,2243397,1724,4879,933900
125,100,96,2243297,1728,4975,934500
126,119,96,2243177,1752,5071,923500
127,106,84,2243072,1773,5155,941900
128,111,89,2242958,1798,5244,960500
129,110,98,2242853,1805,5342,985400
130,145,100,2242703,1855,5442,948800
131,109,91,2242599,1868,5533,989700
132,112,94,2242482,1891,5627,922200
133,121,109,2242363,1901,5736,939600
134,136,94,2242231,1939,5830,913500
135,115,106,2242112,1952,5936,913400
136,120,87,2241999,1978,6023,924800
137,126,98,2241873,2006,6121,995100
138,112,116,2241752,2011,6237,913700
139,119,93,2241632,2038,6330,931000
140,114,113,2241524,2033,6443,972000
141,128,96,2241397,2064,6539,980800
142,135,85,2241257,2119,6624,978500
143,137,108,2241124,2144,6732,1029800
144,121,110,2241002,2156,6842,1006200
145,129,119,2240871,2168,6961,1003200
146,119,108,2240757,2174,7069,975300
147,152,111,2240615,2205,7180,1011300
148,147,110,2240462,2248,7290,993800
149,116,101,2240339,2270,7391,1025800
150,129,124,2240212,2273,7515,1005300
151,135,118,2240071,2296,7633,922900
152,138,128,2239935,2304,7761,940200
153,129,118,2239807,2314,7879,956600
154,142,124,2239671,2326,8003,998600
155,129,127,2239539,2331,8130,998600
156,130,115,2239423,2332,8245,1054400
157,144,137,2239270,2348,8382,1103900
158,126,109,2239141,2368,8491,996700
159,161,128,2238985,2396,8619,993600
160,144,116,2238847,2418,8735,962300
161,115,130,2238717,2418,8865,951000
162,145,123,2238575,2437,8988,941700
163,130,132,2238442,2438,9120,977800
164,158,117,2238284,2479,9237,959000
165,149,156,2238138,2469,9393,955300
166,151,117,2237991,2499,9510,1013100
167,140,126,2237846,2518,9636,1007900
168,168,146,2237682,2536,9782,1278200
169,141,134,2237540,2544,9916,1190300
170,172,140,2237373,2571,10056,1167200
171,127,122,2237236,2586,10178,1162400
172,160,139,2237080,2603,10317,1250800
173,165,140,2236925,2618,10457,1134800
174,150,145,2236770,2628,10602,1127600
175,184,144,2236591,2663,10746,1065100
176,175,128,2236402,2724,10874,1112100
177,165,155,2236243,2728,11029,1036600
178,165,148,2236087,2736,11177,986500
179,178,152,2235914,2757,11329,1209900
180,157,149,2235743,2779,11478,975800
181,183,152,2235569,2801,11630,994300
182,178,153,2235386,2831,11783,1259400
183,159,146,2235223,2848,11929,1062300
184,189,152,2235039,2880,12081,1000500
185,187,149,2234856,2914,12230,953500
186,166,150,2234683,2937,12380,901200
187,184,149,2234501,2970,12529,975600
188,177,164,2234327,2980,12693,979300
189,179,143,2234150,3014,12836,937100
190,194,154,2233968,3042,12990,905200
191,200,146,2233762,3102,13136,967100
192,162,149,2233592,3123,13285,1082800
193,168,149,2233424,3142,13434,1063900
194,162,176,2233254,3136,13610,971100
195,182,164,2233084,3142,13774,923000
196,164,152,2232916,3158,13926,929400
197,174,177,2232740,3157,14103,956500
198,177,170,2232561,3166,14273,935900
199,188,158,2232382,3187,14431,893400
200,164,166,2232203,3200,14597,917400
201,181,170,2232030,3203,14767,940100
202,183,166,2231850,3217,14933,899500
203,183,149,2231663,3255,15082,952400
204,194,182,2231477,3259,15264,917300
205,180,178,2231289,3269,15442,918900
206,176,196,2231111,3251,15638,878300
207,158,190,2230958,3214,15828,866100
208,181,167,2230780,3225,15995,956400
209,200,171,2230581,3253,16166,907300
210,204,169,2230379,3286,16335,1004300
211,165,181,2230205,3279,16516,966400
212,206,150,2230008,3326,16666,883000
213,205,159,2229803,3372,16825,908000
214,163,162,2229634,3379,16987,908100
215,176,177,2229464,3372,17164,876400
216,209,184,2229256,3396,17348,927600
217,185,183,2229072,3397,17531,917300
218,190,179,2228876,3414,17710,958300
219,185,195,2228695,3400,17905,1033000
220,180,171,2228507,3417,18076,931400
221,180,195,2228338,3391,18271,880900
222,196,153,2228143,3433,18424,880500
223,212,192,2227932,3452,18616,871800
224,198,172,2227728,3484,18788,922600
225,210,185,2227537,3490,18973,905000
226,215,197,2227312,3518,19170,905300
227,186,178,2227115,3537,19348,935400
228,231,191,2226889,3572,19539,915000
229,222,187,2226661,3613,19726,898400
230,223,182,2226452,3640,19908,899500
231,220,177,2226224,3691,20085,987500
232,212,201,2226019,3695,20286,959900
233,217,184,2225796,3734,20470,885500
234,243,203,2225569,3758,20673,867000
235,214,185,2225346,3796,20858,987200
236,227,215,2225125,3802,21073,922200
237,238,196,2224878,3853,21269,897500
238,242,195,2224629,3907,21464,889100
239,217,206,2224412,3918,21670,877100
240,229,208,2224199,3923,21878,867200
241,245,209,2223940,3973,22087,885100
242,251,228,2223705,3980,22315,886000
243,220,189,2223465,4031,22504,925600
244,272,221,2223210,4065,22725,958700
245,250,192,2222942,4141,22917,1014900
246,238,196,2222719,4168,23113,913500
247,216,189,2222495,4203,23302,927800
248,258,206,2222247,4245,23508,973000
249,235,207,2222007,4278,23715,1014400
250,227,210,2221776,4299,23925,979900
251,226,209,2221550,4316,24134,976900
252,240,219,2221307,4340,24353,917200
253,263,243,2221055,4349,24596,947800
254,204,216,2220839,4349,24812,934400
255,273,231,2220579,4378,25043,952100
256,236,204,2220329,4424,25247,911600
257,242,262,2220101,4390,25509,898600
258,257,228,2219846,4417,25737,964200
259,229,231,2219599,4433,25968,915000
260,253,218,2219362,4452,26186,894800
261,242,232,2219109,4473,26418,906400
262,242,231,2218862,4489,26649,905900
263,268,266,2218605,4480,26915,881900
264,237,236,2218361,4488,27151,929700
265,258,215,2218117,4517,27366,916700
266,261,204,2217861,4569,27570,967300
267,268,239,2217595,4596,27809,902500
268,239,226,2217336,4629,28035,870400
269,267,215,2217084,4666,28250,878600
270,232,251,2216846,4653,28501,935900
271,236,257,2216616,4626,28758,914100
272,265,231,2216351,4660,28989,966700
273,274,236,2216072,4703,29225,919300
274,268,249,2215810,4716,29474,911100
275,279,254,2215535,4737,29728,912400
276,267,259,2215250,4763,29987,873000
277,277,264,2214979,4770,30251,878100
278,289,245,2214696,4808,30496,924900
279,291,250,2214400,4854,30746,1136300
280,271,272,2214139,4843,31018,943900
281,268,257,2213862,4863,31275,911700
282,305,226,2213555,4944,31501,945500
283,300,245,2213255,4999,31746,891700
284,294,250,2212966,5038,31996,845200
285,278,278,2212676,5050,32274,958500
286,305,270,2212399,5057,32544,934500
287,272,278,2212115,5063,32822,988000
288,312,264,2211796,5118,33086,912900
289,271,254,2211526,5134,33340,895600
290,284,269,2211235,5156,33609,883700
291,241,278,2210987,5126,33887,974400
292,323,259,2210683,5171,34146,863900
293,273,281,2210397,5176,34427,900000
294,289,288,2210121,5164,34715,897800
295,297,263,2209813,5209,34978,911800
296,263,256,2209556,5210,35234,959400
297,291,250,2209275,5241,35484,939900
298,307,283,2208967,5266,35767,937600
299,310,262,2208659,5312,36029,907000
300,295,289,2208349,5333,36318,886000
301,306,253,2208046,5383,36571,905200
302,326,286,2207740,5403,36857,978300
303,304,269,2207420,5454,37126,960800
304,269,314,2207138,5422,37440,943800
305,281,293,2206866,5401,37733,975500
306,279,269,2206583,5415,38002,991000
307,291,260,2206288,5450,38262,1008300
308,322,278,2205992,5468,38540,989000
309,317,309,2205686,5465,38849,922200
310,303,299,2205358,5494,39148,963100
311,290,303,2205084,5465,39451,938800
312,279,293,2204789,5467,39744,955000
313,301,305,2204501,5450,40049,963600
314,285,296,2204199,5456,40345,909600
315,324,286,2203894,5475,40631,882800
316,331,250,2203553,5566,40881,909500
317,315,306,2203245,5568,41187,909500
318,357,287,2202887,5639,41474,885900
319,335,306,2202542,5678,41780,895900
320,313,279,2202225,5716,42059,890500
321,334,294,2201894,5753,42353,919800
322,342,280,2201555,5812,42633,943900
323,339,313,2201234,5820,42946,1061000
324,352,263,2200876,5915,43209,936700
325,320,302,2200545,5944,43511,939700
326,358,279,2200197,6013,43790,961500
327,334,282,2199865,6063,44072,896300
328,345,339,2199515,6074,44411,883100
329,324,350,2199190,6049,44761,915800
330,311,328,2198865,6046,45089,946500
331,303,313,2198564,6034,45402,904900
332,318,309,2198254,6035,45711,920100
333,304,308,2197960,6021,46019,937900
334,347,305,2197624,6052,46324,930200
335,356,327,2197254,6095,46651,881300
336,307,315,2196937,6097,46966,1049100
337,336,305,2196608,6121,47271,914600
338,327,327,2196295,6107,47598,892500
339,325,347,2195958,6097,47945,1013600
340,332,328,2195625,6102,48273,946800
341,347,306,2195290,6131,48579,905800
342,366,289,2194921,6211,48868,899900
343,313,347,2194610,6175,49215,940500
344,343,343,2194267,6175,49558,887300
345,332,355,2193927,6160,49913,912000
346,294,324,2193624,6139,50237,870100
347,349,339,2193275,6149,50576,906200
348,349,309,2192948,6167,50885,965300
349,332,294,2192594,6227,51179,913800
350,366,325,2192234,6262,51504,880700
351,323,345,2191915,6236,51849,870600
352,338,328,2191589,6234,52177,983200
353,345,363,2191239,6221,52540,941300
354,318,341,2190902,6217,52881,960300
355,359,339,2190550,6230,53220,929300
356,345,308,2190207,6265,53528,930900
357,348,328,2189867,6277,53856,938700
358,337,353,2189535,6256,54209,896700
359,364,338,2189161,6292,54547,898800
360,362,362,2188798,6293,54909,873400
361,340,330,2188467,6294,55239,1046800
362,360,311,2188095,6355,55550,952100
363,344,306,2187744,6400,55856,904400
364,348,339,2187409,6396,56195,957300
365,362,373,2187047,6385,56568,1094100
366,326,323,2186720,6389,56891,1064900
367,332,308,2186377,6424,57199,994800
368,332,315,2186044,6442,57514,965300
369,362,323,2185695,6468,57837,985700
370,355,329,2185341,6493,58166,947100
371,350,357,2184991,6486,58523,926900
372,342,327,2184651,6499,58850,860700
373,372,345,2184290,6515,59195,919800
374,366,337,2183910,6558,59532,918900
375,375,387,2183541,6540,59919,924500
376,390,343,2183149,6589,60262,914500
377,387,336,2182757,6645,60598,919000
378,397,359,2182357,6686,60957,956300
379,364,342,2181993,6708,61299,969400
380,380,322,2181627,6752,61621,924100
381,390,346,2181234,6799,61967,996400
382,391,322,2180839,6872,62289,979800
383,385,367,2180460,6884,62656,1064800
384,409,341,2180045,6958,62997,984600
385,347,342,2179708,6953,63339,941600
386,394,380,2179304,6977,63719,946100
387,381,363,2178926,6992,64082,958600
388,380,346,2178561,7011,64428,948200
389,382,368,2178150,7054,64796,914900
390,367,360,2177797,7047,65156,970800
391,375,383,2177410,7051,65539,1043500
392,378,384,2177046,7031,65923,1060600
393,375,335,2176673,7069,66258,1097100
394,372,384,2176302,7056,66642,973700
395,374,375,2175917,7066,67017,997400
396,385,344,2175546,7093,67361,969100
397,354,362,2175190,7087,67723,955100
398,347,346,2174838,7093,68069,935400
399,340,380,2174499,7052,68449,999300
400,376,378,2174137,7036,68827,1065000
401,355,385,2173761,7027,69212,1012900
402,365,354,2173387,7047,69566,944800
403,369,365,2173016,7053,69931,947400
404,374,370,2172666,7033,70301,963000
405,396,375,2172265,7059,70676,948100
406,377,351,2171896,7077,71027,959100
407,382,386,2171501,7086,71413,979500
408,391,398,2171111,7078,71811,966500
409,385,362,2170735,7092,72173,996900
410,420,370,2170301,7156,72543,981800
411,374,373,2169939,7145,72916,920600
412,408,388,2169522,7174,73304,933300
413,470,374,2169074,7248,73678,911700
414,416,360,2168656,7306,74038,927000
415,431,407,2168211,7344,74445,962300
416,399,361,2167810,7384,74806,921700
417,406,421,2167414,7359,75227,987100
418,380,366,2167034,7373,75593,1025300
419,428,374,2166610,7423,75967,1101200
420,443,414,2166152,7467,76381,1017900
421,413,397,2165756,7466,76778,1140300
422,450,358,2165311,7553,77136,1107200
423,402,391,2164912,7561,77527,1020100
424,428,432,2164488,7553,77959,1058400
425,428,345,2164041,7655,78304,1046300
426,478,389,2163582,7725,78693,1069300
427,444,412,2163115,7780,79105,911800
428,433,419,2162686,7790,79524,881700
429,429,422,2162264,7790,79946,893800
430,457,416,2161797,7841,80362,1025700
431,448,413,2161361,7864,80775,980700
432,424,390,2160921,7914,81165,926000
433,411,414,2160501,7920,81579,910200
434,444,427,2160097,7897,82006,931400
435,430,427,2159639,7928,82433,907600
436,464,389,2159193,7985,82822,900000
437,453,426,2158725,8027,83248,891100
438,432,422,2158295,8035,83670,910900
439,445,409,2157864,8057,84079,941400
440,466,459,2157382,8080,84538,919000
441,453,437,2156945,8080,84975,926400
442,454,437,2156484,8104,85412,936500
443,409,429,2156070,8089,85841,926000
444,414,422,2155649,8088,86263,916500
445,451,420,2155214,8103,86683,944300
446,419,433,2154776,8108,87116,899700
447,413,432,2154380,8072,87548,906000
448,445,404,2153922,8126,87952,966400
449,466,455,2153471,8122,88407,892600
450,459,407,2153007,8179,88814,893600
451,416,434,2152582,8170,89248,879200
452,453,415,2152136,8201,89663,900900
453,457,444,2151691,8202,90107,923400
454,442,405,2151243,8245,90512,1011500
455,456,453,2150792,8243,90965,959400
456,443,433,2150321,8281,91398,922700
457,445,439,2149896,8267,91837,934200
458,448,444,2149459,8260,92281,932300
459,489,445,2148973,8301,92726,958900
460,448,436,2148502,8336,93162,976600
461,469,418,2148056,8364,93580,958600
462,468,456,2147588,8376,94036,910500
463,466,437,2147115,8412,94473,894200
464,451,449,2146656,8422,94922,889500
465,451,429,2146216,8433,95351,889100
466,421,409,2145775,8465,95760,900500
467,471,441,2145315,8484,96201,883900
468,426,420,2144870,8509,96621,911700
469,498,420,2144415,8544,97041,899100
470,448,422,2143961,8576,97463,957500
471,424,433,2143518,8586,97896,922700
472,477,462,2143043,8599,98358,974000
473,457,470,2142580,8592,98828,1000700
474,466,460,2142129,8583,99288,960400
475,453,419,2141663,8630,99707,935100
476,460,440,2141198,8655,100147,924600
477,486,440,2140749,8664,100587,1015100
478,516,442,2140229,8742,101029,970200
479,486,463,2139717,8791,101492,953600
480,489,422,2139231,8855,101914,991800
481,500,489,2138746,8851,102403,995900
482,532,467,2138219,8911,102870,982900
483,456,471,2137739,8920,103341,918500
484,473,461,2137269,8929,103802,966000
485,511,464,2136767,8967,104266,910900
486,474,473,2136293,8968,104739,1041900
487,496,464,2135789,9008,105203,968700
488,501,459,2135304,9034,105662,920200
489,472,451,2134816,9071,106113,915900
490,471,477,2134348,9062,106590,905100
491,503,482,2133855,9073,107072,914600
492,519,492,2133313,9123,107564,947500
493,529,485,2132799,9152,108049,883200
494,491,463,2132311,9177,108512,947200
495,533,488,2131772,9228,109000,926400
496,521,491,2131261,9248,109491,952700
497,450,477,2130787,9245,109968,1075400
498,521,476,2130289,9267,110444,910500
499,558,485,2129736,9335,110929,887700
500,476,493,2129244,9334,111422,986100
501,474,448,2128765,9365,111870,993800
502,489,489,2128286,9355,112359,966700
503,488,480,2127786,9375,112839,941400
504,496,504,2127292,9365,113343,981300
505,515,492,2126800,9365,113835,936800
506,510,498,2126270,9397,114333,938400
507,498,533,2125784,9350,114866,938300
508,515,472,2125254,9408,115338,917400
509,460,457,2124790,9415,115795,970000
510,543,493,2124279,9433,116288,918900
511,522,471,2123745,9496,116759,945000
512,548,489,2123224,9528,117248,950400
513,504,521,2122695,9536,117769,956300
514,571,518,2122131,9582,118287,1004500
515,542,481,2121587,9645,118768,972900
516,532,482,2121068,9682,119250,974500
517,498,499,2120546,9705,119749,920200
518,526,523,2120026,9702,120272,961600
519,555,506,2119460,9762,120778,974300
520,526,495,2118946,9781,121273,952700
521,555,538,2118413,9776,121811,972900
522,529,506,2117861,9822,122317,990100
523,539,521,2117324,9838,122838,1015100
524,559,510,2116765,9887,123348,948800
525,583,525,2116186,9941,123873,982100
526,553,515,2115625,9987,124388,956300
527,531,533,2115106,9973,124921,1039100
528,566,489,2114548,10042,125410,982100
529,544,521,2113984,10085,125931,989200
530,592,536,2113406,10127,126467,1039000
531,582,533,2112806,10194,127000,943700
532,575,536,2112247,10217,127536,953800
533,559,538,2111694,10232,128074,978300
534,545,552,2111116,10258,128626,948700
535,583,559,2110554,10261,129185,1070800
536,577,542,2109984,10289,129727,993300
537,562,536,2109424,10313,130263,946500
538,548,511,2108863,10363,130774,1019200
539,553,549,2108297,10380,131323,1100000
540,538,536,2107790,10351,131859,1049400
541,570,501,2107216,10424,132360,962600
542,553,509,2106637,10494,132869,964500
543,541,571,2106114,10446,133440,1212100
544,532,536,2105558,10466,133976,946700
545,579,546,2105003,10475,134522,933000
546,583,543,2104434,10501,135065,919900
547,573,510,2103848,10577,135575,922400
548,573,565,2103279,10581,136140,995300
549,652,575,2102638,10647,136715,995200
550,560,574,2102069,10642,137289,948300
551,526,550,2101508,10653,137839,916500
552,566,537,2100971,10653,138376,913900
553,607,559,2100378,10687,138935,937700
554,546,540,2099815,10710,139475,957600
555,595,563,2099216,10746,140038,1004900
556,568,515,2098672,10775,140553,959500
557,581,548,2098064,10835,141101,1002000
558,585,560,2097496,10843,141661,1065700
559,571,535,2096920,10884,142196,926400
560,552,576,2096353,10875,142772,947200
561,590,575,2095779,10874,143347,945000
562,597,573,2095186,10894,143920,948300
563,593,606,2094584,10890,144526,962300
564,576,558,2094002,10914,145084,941600
565,589,526,2093412,10978,145610,945000
566,581,566,2092847,10977,146176,956000
567,606,581,2092255,10988,146757,980400
568,551,542,2091682,11019,147299,961300
569,552,527,2091124,11050,147826,926200
570,624,560,2090505,11109,148386,897100
571,557,601,2089934,11079,148987,968100
572,620,633,2089342,11038,149620,986500
573,611,547,2088723,11110,150167,935300
574,591,635,2088117,11081,150802,968100
575,545,530,2087582,11086,151332,971400
576,577,580,2087006,11082,151912,937500
577,520,571,2086477,11040,152483,963900
578,546,553,2085945,11019,153036,965400
579,573,573,2085365,11026,153609,929700
580,546,579,2084805,11007,154188,962600
581,578,578,2084257,10977,154766,916400
582,579,587,2083659,10988,155353,960600
583,608,600,2083062,10985,155953,984900
584,623,593,2082441,11013,156546,964800
585,572,587,2081867,11000,157133,936300
586,590,577,2081275,11015,157710,933000
587,614,559,2080657,11074,158269,924800
588,577,603,2080066,11062,158872,968700
589,588,578,2079487,11063,159450,970400
590,590,592,2078912,11046,160042,949600
591,589,592,2078309,11057,160634,965000
592,570,563,2077748,11055,161197,1029600
593,594,593,2077146,11064,161790,1042800
594,621,622,2076544,11044,162412,1028300
595,551,624,2075976,10988,163036,1041800
596,583,598,2075392,10974,163634,1131500
597,618,586,2074801,10979,164220,1043800
598,554,546,2074220,11014,164766,1005900
599,633,578,2073614,11042,165344,1025400
600,598,570,2073015,11071,165914,1135700
601,620,583,2072387,11116,166497,1009400
602,580,564,2071795,11144,167061,1007400
603,578,608,2071214,11117,167669,971700
604,588,567,2070621,11143,168236,923800
605,621,587,2070004,11173,168823,963000
606,625,570,2069401,11206,169393,952700
607,622,557,2068768,11282,169950,953700
608,613,600,2068160,11290,170550,979400
609,595,617,2067561,11272,171167,1010600
610,616,592,2066954,11287,171759,1010400
611,645,578,2066295,11368,172337,942800
612,622,615,2065705,11343,172952,985300
613,577,635,2065097,11316,173587,1161400
614,664,553,2064458,11402,174140,968200
615,596,553,2063835,11472,174693,931000
616,613,583,2063236,11488,175276,956300
617,618,638,2062619,11467,175914,1008600
618,583,577,2062027,11482,176491,929300
619,614,588,2061410,11511,177079,922200
620,662,580,2060755,11586,177659,909200
621,611,630,2060138,11573,178289,953500
622,596,595,2059545,11571,178884,974700
623,642,625,2058904,11587,179509,19159300
624,653,590,2058233,11668,180099,1636800
625,614,628,2057631,11642,180727,1473200
626,640,601,2056983,11689,181328,1411300
627,611,581,2056372,11719,181909,1184300
628,581,560,2055794,11737,182469,1048900
629,634,590,2055189,11752,183059,1024900
630,601,628,2054561,11752,183687,998600
631,597,616,2053952,11745,184303,1086100
632,578,603,2053390,11704,184906,1090600
633,535,601,2052843,11650,185507,1068800
634,668,598,2052188,11707,186105,1010300
635,659,625,2051541,11729,186730,1083800
636,650,608,2050880,11782,187338,1077400
637,620,587,2050255,11820,187925,1117400
638,645,622,2049626,11827,188547,1008900
639,601,670,2049001,11782,189217,967400
640,591,640,2048422,11721,189857,977300
641,571,578,2047844,11721,190435,1024100
642,595,615,2047242,11708,191050,1030800
643,588,623,2046658,11669,191673,985600
644,608,620,2046044,11663,192293,1012700
645,646,633,2045410,11664,192926,1013600
646,642,674,2044762,11638,193600,956300
647,589,542,2044161,11697,194142,942500
648,671,608,2043519,11731,194750,961400
649,678,600,2042838,11812,195350,1009700
650,648,623,2042183,11844,195973,987600
651,660,614,2041535,11878,196587,1000400
652,605,665,2040916,11832,197252,978000
653,676,633,2040247,11868,197885,983700
654,623,622,2039617,11876,198507,990700
655,635,635,2038996,11862,199142,996000
656,696,605,2038320,11933,199747,971600
657,631,609,2037672,11972,200356,1079000
658,644,645,2037026,11973,201001,1062900
659,673,645,2036352,12002,201646,1036700
660,654,623,2035690,12041,202269,1010400
661,615,650,2035083,11998,202919,1018400
662,677,637,2034407,12037,203556,988300
663,657,646,2033738,12060,204202,961500
664,646,608,2033133,12057,204810,944500
665,594,613,2032490,12087,205423,932100
666,668,610,2031843,12124,206033,980900
667,708,623,2031140,12204,206656,1002400
668,668,634,2030465,12245,207290,985500
669,653,686,2029804,12220,207976,948900
670,677,666,2029146,12212,208642,1006800
671,674,661,2028475,12222,209303,997900
672,708,657,2027759,12281,209960,975400
673,678,626,2027078,12336,210586,964700
674,623,640,2026430,12344,211226,973100
675,672,659,2025786,12329,211885,958100
676,614,627,2025145,12343,212512,1029000
677,679,675,2024474,12339,213187,975900
678,655,608,2023822,12383,213795,1009600
679,645,625,2023186,12394,214420,974100
680,640,647,2022557,12376,215067,919500
681,667,630,2021885,12418,215697,965800
682,662,660,2021241,12402,216357,985100
683,624,656,2020583,12404,217013,992400
684,688,670,2019933,12384,217683,1058600
685,658,682,2019271,12364,218365,993600
686,661,614,2018592,12429,218979,997400
687,661,624,2017906,12491,219603,985800
688,640,682,2017275,12440,220285,1066500
689,674,677,2016608,12430,220962,974900
690,573,653,2016029,12356,221615,998500
691,630,620,2015391,12374,222235,1077300
692,637,642,2014759,12364,222877,1101000
693,637,665,2014146,12312,223542,1064800
694,627,605,2013517,12336,224147,1057200
695,639,650,2012871,12332,224797,1095600
696,678,607,2012197,12399,225404,1353100
697,647,693,2011544,12359,226097,1123800
698,622,633,2010913,12357,226730,1048300
699,654,629,2010280,12361,227359,1043200
700,631,628,2009628,12385,227987,1037300
701,724,689,2008916,12408,228676,955100
702,674,665,2008234,12425,229341,976100
703,630,634,2007626,12399,229975,972100
704,707,662,2006915,12448,230637,996700
705,661,690,2006245,12428,231327,1012800
706,622,610,2005618,12445,231937,1015400
707,672,601,2004961,12501,232538,1045900
708,654,680,2004295,12487,233218,1055500
709,651,639,2003652,12491,233857,1132700
710,671,662,2002962,12519,234519,1023600
711,700,650,2002284,12547,235169,1095200
712,694,727,2001603,12501,235896,1068700
713,607,646,2000962,12496,236542,1018900
714,630,650,2000339,12469,237192,991300
715,677,647,1999647,12514,237839,995300
716,628,661,1999029,12471,238500,977900
717,690,642,1998378,12480,239142,1011700
718,687,628,1997681,12549,239770,1030200
719,667,680,1996984,12566,240450,1038700
720,696,652,1996303,12595,241102,1031200
721,679,655,1995637,12606,241757,997800
722,676,655,1994952,12636,242412,1049000
723,731,667,1994224,12697,243079,1002300
724,738,668,1993455,12798,243747,1020300
725,659,665,1992814,12774,244412,1031100
726,690,694,1992145,12749,245106,1069100
727,672,687,1991431,12776,245793,1023500
728,694,625,1990770,12812,246418,1013200
729,707,717,1990066,12799,247135,1016200
730,688,689,1989350,12826,247824,972900
731,699,622,1988686,12868,248446,1008300
732,694,685,1987975,12894,249131,993900
733,664,675,1987340,12854,249806,1016600
734,667,677,1986642,12875,250483,1073200
735,653,676,1985998,12843,251159,1054100
736,685,653,1985318,12870,251812,990900
737,724,668,1984611,12909,252480,976000
738,686,633,1983904,12983,253113,979400
739,701,708,1983191,12988,253821,983800
740,706,707,1982486,12986,254528,1048700
741,688,683,1981807,12982,255211,999500
742,748,700,1981057,13032,255911,1158900
743,771,697,1980324,13068,256608,1052300
744,735,693,1979536,13163,257301,1026600
745,681,709,1978876,13114,258010,1109500
746,706,722,1978169,13099,258732,1086700
747,759,685,1977415,13168,259417,1092100
748,727,663,1976672,13248,260080,1101200
749,735,708,1975950,13262,260788,1149300
750,693,679,1975259,13274,261467,1075100
751,733,723,1974551,13259,262190,1099800
752,718,626,1973804,13380,262816,1072500
753,710,730,1973094,13360,263546,1034600
754,696,677,1972391,13386,264223,994700
755,676,716,1971720,13341,264939,983800
756,735,665,1970996,13400,265604,1015700
757,742,707,1970248,13441,266311,1013300
758,693,742,1969566,13381,267053,1100700
759,761,705,1968790,13452,267758,1016600
760,705,724,1968104,13414,268482,1183300
761,715,697,1967396,13425,269179,1047600
762,713,713,1966643,13465,269892,1151800
763,692,703,1965969,13436,270595,1017500
764,713,692,1965246,13467,271287,1014500
765,696,657,1964578,13478,271944,978100
766,673,693,1963852,13511,272637,1119700
767,675,680,1963224,13459,273317,1046000
768,715,686,1962501,13496,274003,966100
769,736,700,1961785,13512,274703,1005300
770,762,652,1961001,13644,275355,1045500
771,740,725,1960260,13660,276080,966500
772,729,719,1959518,13683,276799,972700
773,679,687,1958853,13661,277486,1005300
774,751,676,1958115,13723,278162,1018400
775,744,708,1957353,13777,278870,983800
776,774,721,1956589,13820,279591,964400
777,812,743,1955785,13881,280334,986700
778,787,772,1954991,13903,281106,1000400
779,737,740,1954266,13888,281846,966300
780,723,726,1953522,13906,282572,944800
781,679,699,1952837,13892,283271,967100
782,700,710,1952121,13898,283981,988300
783,729,714,1951400,13905,284695,1010900
784,711,718,1950695,13892,285413,953500
785,740,734,1949966,13887,286147,984800
786,717,683,1949250,13920,286830,1049300
787,790,719,1948467,13984,287549,1011500
788,684,744,1947747,13960,288293,976000
789,775,706,1947026,13975,288999,979500
790,727,728,1946271,14002,289727,959300
791,708,689,1945542,14042,290416,972100
792,695,744,1944846,13994,291160,986300
793,747,746,1944134,13960,291906,1015000
794,763,749,1943360,13985,292655,941600
795,690,735,1942659,13951,293390,988200
796,697,743,1941980,13887,294133,995200
797,745,789,1941224,13854,294922,995000
798,736,696,1940487,13895,295618,1170500
799,733,708,1939758,13916,296326,1068400
800,707,737,1939063,13874,297063,1035500
801,775,776,1938276,13885,297839,1035100
802,741,708,1937503,13950,298547,1054600
803,669,698,1936852,13903,299245,1057600
804,689,730,1936186,13839,299975,1020600
805,718,709,1935452,13864,300684,1025100
806,717,680,1934740,13896,301364,974200
807,760,699,1933981,13956,302063,1180400
808,688,685,1933279,13973,302748,1016100
809,791,746,1932509,13997,303494,993700
810,742,686,1931764,14056,304180,990400
811,753,766,1931007,14047,304946,949800
812,735,702,1930280,14072,305648,1032300
813,745,689,1929526,14137,306337,1026700
814,786,737,1928737,14189,307074,1005100
815,766,706,1927965,14255,307780,1010700
816,768,715,1927218,14287,308495,982800
817,781,728,1926427,14350,309223,1001200
818,700,756,1925732,14289,309979,1000200
819,734,761,1924995,14265,310740,1009500
820,719,766,1924276,14218,311506,954400
821,747,720,1923528,14246,312226,984700
822,738,734,1922801,14239,312960,973300
823,775,772,1922031,14237,313732,968200
824,765,768,1921249,14251,314500,990500
825,693,734,1920550,14216,315234,1042200
826,762,706,1919788,14272,315940,1022500
827,757,747,1919033,14280,316687,1019600
828,733,779,1918310,14224,317466,1066100
829,689,748,1917612,14174,318214,1092900
830,755,724,1916894,14168,318938,1092300
831,787,773,1916096,14193,319711,1085600
832,742,756,1915339,14194,320467,1052500
833,760,709,1914578,14246,321176,974700
834,726,769,1913847,14208,321945,1064700
835,748,748,1913110,14197,322693,1034200
836,808,734,1912309,14264,323427,1071500
837,700,703,1911585,14285,324130,1082800
838,751,772,1910868,14230,324902,1044200
839,778,755,1910070,14273,325657,1027700
840,785,709,1909310,14324,326366,1001400
841,734,738,1908541,14355,327104,964900
842,778,771,1907785,14340,327875,975400
843,786,767,1906973,14385,328642,984000
844,733,758,1906235,14365,329400,1005700
845,785,811,1905487,14302,330211,967200
846,741,698,1904704,14387,330909,975100
847,817,739,1903907,14445,331648,967600
848,758,766,1903161,14425,332414,1035100
849,727,735,1902390,14461,333149,1104900
850,763,727,1901665,14459,333876,1083800
851,801,734,1900877,14513,334610,1138800
852,759,775,1900104,14511,335385,1041800
853,759,721,1899346,14548,336106,1029900
854,747,765,1898590,14539,336871,1104400
855,791,692,1897815,14622,337563,1012200
856,823,779,1896998,14660,338342,1025600
857,813,789,1896178,14691,339131,1018400
858,808,830,1895337,14702,339961,1118200
859,789,761,1894577,14701,340722,1112400
860,797,758,1893761,14759,341480,1067800
861,818,776,1892971,14773,342256,1031500
862,799,773,1892157,14814,343029,1051800
863,725,759,1891400,14812,343788,975800
864,794,774,1890635,14803,344562,1065200
865,828,737,1889832,14869,345299,1012000
866,834,739,1888976,14986,346038,968400
867,800,814,1888173,14975,346852,1068700
868,811,764,1887372,15012,347616,1018200
869,779,762,1886595,15027,348378,1036000
870,792,738,1885777,15107,349116,1046700
871,752,802,1885044,15038,349918,1020500
872,766,784,1884297,15001,350702,1011500
873,746,767,1883521,15010,351469,960000
874,845,742,1882712,15077,352211,1000100
875,847,802,1881866,15121,353013,1023300
876,731,755,1881083,15149,353768,1251800
877,789,747,1880324,15161,354515,1000500
878,786,779,1879517,15189,355294,1056600
879,833,792,1878712,15202,356086,1008100
880,752,828,1877949,15137,356914,1001300
881,829,772,1877120,15194,357686,1005700
882,753,801,1876369,15144,358487,1061900
883,787,842,1875585,15086,359329,1033500
884,753,794,1874807,15070,360123,1039400
885,754,737,1874037,15103,360860,1042700
886,840,805,1873249,15086,361665,1034500
887,790,771,1872459,15105,362436,1039800
888,773,787,1871667,15110,363223,1183300
889,773,796,1870899,15082,364019,1077500
890,829,793,1870078,15110,364812,1042000
891,805,782,1869268,15138,365594,1082100
892,834,791,1868419,15196,366385,1062300
893,805,813,1867624,15178,367198,1110200
894,770,809,1866854,15139,368007,1034500
895,792,776,1866032,15185,368783,1067600
896,782,840,1865295,15082,369623,1008300
897,806,802,1864473,15102,370425,1000200
898,698,736,1863758,15081,371161,1008000
899,795,785,1862968,15086,371946,1021100
900,819,815,1862173,15066,372761,1005600
901,720,774,1861425,15040,373535,1037800
902,734,834,1860705,14926,374369,1021500
903,738,778,1859971,14882,375147,1054000
904,765,785,1859205,14863,375932,1105800
905,782,759,1858418,14891,376691,1087900
906,765,790,1857660,14859,377481,1023600
907,807,788,1856855,14876,378269,1044800
908,742,781,1856103,14847,379050,1022600
909,790,771,1855321,14858,379821,999000
910,779,753,1854538,14888,380574,1186500
911,791,748,1853740,14938,381322,1049600
912,825,811,1852951,14916,382133,1028100
913,829,771,1852117,14979,382904,1157400
914,786,748,1851324,15024,383652,1195400
915,837,806,1850463,15079,384458,1096700
916,767,796,1849719,15027,385254,1031400
917,829,806,1848885,15055,386060,1110800
918,833,785,1848044,15111,386845,1133400
919,842,800,1847196,15159,387645,1215200
920,783,778,1846421,15156,388423,1051700
921,862,798,1845573,15206,389221,1044600
922,791,814,1844775,15190,390035,1023600
923,825,801,1843970,15194,390836,1034000
924,871,797,1843102,15265,391633,1054100
925,860,794,1842214,15359,392427,1070700
926,892,803,1841340,15430,393230,1037100
927,823,802,1840487,15481,394032,1040800
928,856,817,1839649,15502,394849,1068800
929,916,753,1838763,15635,395602,1054200
930,870,830,1837868,15700,396432,1056100
931,856,811,1837013,15744,397243,1040500
932,873,815,1836116,15826,398058,1076400
933,873,812,1835272,15858,398870,1008500
934,805,813,1834465,15852,399683,1080100
935,840,819,1833602,15896,400502,1073300
936,873,810,1832765,15923,401312,1058700
937,839,813,1831918,15957,402125,1031700
938,864,826,1831061,15988,402951,993300
939,873,820,1830196,16033,403771,1033400
940,882,828,1829299,16102,404599,987100
941,866,811,1828438,16152,405410,1027600
942,918,858,1827508,16224,406268,1014700
943,907,871,1826610,16251,407139,1161700
944,833,819,1825762,16280,407958,1082400
945,833,850,1824918,16274,408808,1030700
946,822,843,1824120,16229,409651,1052500
947,820,863,1823275,16211,410514,1006000
948,846,822,1822430,16234,411336,1030800
949,842,838,1821613,16213,412174,1016700
950,831,797,1820769,16260,412971,1047600
951,849,860,1819917,16252,413831,1071900
952,906,850,1819030,16289,414681,1025500
953,840,850,1818188,16281,415531,1020100
954,851,795,1817336,16338,416326,1016000
955,921,850,1816409,16415,417176,1031300
956,820,867,1815591,16366,418043,1035600
957,858,879,1814723,16355,418922,1101100
958,872,864,1813852,16362,419786,1032900
959,868,830,1812975,16409,420616,1006800
960,847,886,1812141,16357,421502,1074000
961,887,823,1811279,16396,422325,1023600
962,849,873,1810378,16424,423198,1012500
963,878,872,1809543,16387,424070,1041800
964,852,869,1808673,16388,424939,990600
965,869,850,1807809,16402,425789,1019800
966,928,876,1806902,16433,426665,987500
967,910,793,1805979,16563,427458,1039200
968,899,860,1805078,16604,428318,1029100
969,832,917,1804235,16530,429235,1032700
970,866,869,1803388,16508,430104,1141700
971,923,873,1802457,16566,430977,1186500
972,834,883,1801609,16531,431860,1230400
973,827,817,1800781,16542,432677,1146700
974,837,839,1799924,16560,433516,1128500
975,798,891,1799152,16441,434407,1096200
976,904,888,1798268,16437,435295,1059200
977,843,895,1797412,16398,436190,1087400
978,793,848,1796591,16371,437038,1050000
979,814,908,1795805,16249,437946,1127300
980,852,861,1794926,16267,438807,1092200
981,863,826,1794109,16258,439633,1084200
982,853,789,1793224,16354,440422,1088700
983,872,869,1792362,16347,441291,1047000
984,846,841,1791531,16337,442132,1062300
985,858,826,1790678,16364,442958,1058300
986,832,834,1789827,16381,443792,1044600
987,811,808,1788995,16405,444600,1055300
988,844,848,1788169,16383,445448,1085900
989,829,854,1787335,16363,446302,1023900
990,856,856,1786470,16372,447158,1083900
991,846,834,1785647,16361,447992,1053400
992,901,849,1784729,16430,448841,1006800
993,810,850,1783905,16404,449691,1010100
994,867,830,1783071,16408,450521,1054000
995,849,858,1782209,16412,451379,1093900
996,818,842,1781378,16401,452221,1080100
997,846,867,1780535,16377,453088,1035500
998,821,868,1779723,16321,453956,1100000
999,818,875,1778905,16264,454831,1141500
1000,828,797,1778057,16315,455628,1107500
1001,846,863,1777210,16299,456491,1173100
1002,861,835,1776364,16310,457326,1310400
1003,841,872,1775524,16278,458198,1309500
1004,821,844,1774698,16260,459042,1175200
1005,827,847,1773875,16236,459889,1174500
1006,843,916,1773061,16134,460805,1205200
1007,870,860,1772180,16155,461665,1258900
1008,849,884,1771325,16126,462549,1180300
1009,914,823,1770411,16217,463372,1200300
1010,871,826,1769514,16288,464198,1093700
1011,850,869,1768689,16244,465067,1088600
1012,887,824,1767795,16314,465891,1128200
1013,860,810,1766935,16364,466701,1017600
1014,858,840,1766069,16390,467541,989600
1015,923,868,1765189,16402,468409,1084900
1016,896,834,1764258,16499,469243,1089200
1017,924,833,1763334,16590,470076,1059700
1018,877,866,1762462,16596,470942,1055800
1019,878,880,1761597,16581,471822,997100
1020,877,834,1760704,16640,472656,1144200
1021,874,865,1759860,16619,473521,1062400
1022,893,829,1758958,16692,474350,1107400
1023,976,851,1758018,16781,475201,1004300
1024,964,932,1757007,16860,476133,1062100
1025,890,878,1756122,16867,477011,1064800
1026,953,901,1755184,16904,477912,2494200
1027,948,873,1754217,16998,478785,1037000
1028,889,894,1753331,16990,479679,1007100
1029,928,853,1752399,17069,480532,1022700
1030,897,900,1751491,17077,481432,951000
1031,902,933,1750619,17016,482365,968000
1032,887,854,1749709,17072,483219,1032600
1033,888,889,1748835,17057,484108,1102900
1034,873,918,1747946,17028,485026,1079400
1035,920,895,1747018,17061,485921,1044500
1036,884,848,1746144,17087,486769,982700
1037,829,867,1745305,17059,487636,1014200
1038,878,837,1744454,17073,488473,971900
1039,867,851,1743561,17115,489324,939100
1040,871,885,1742698,17093,490209,1004400
1041,856,884,1741815,17092,491093,1028800
1042,848,887,1740978,17042,491980,1000300
1043,900,888,1740127,17005,492868,974200
1044,831,883,1739274,16975,493751,969800
1045,841,904,1738423,16922,494655,957400
1046,861,917,1737547,16881,495572,982300
1047,826,833,1736749,16846,496405,1016300
1048,882,883,1735842,16870,497288,947400
1049,851,836,1734987,16889,498124,979400
1050,928,853,1734086,16937,498977,977600
1051,862,938,1733214,16871,499915,958000
1052,852,873,1732339,16873,500788,963100
1053,876,858,1731494,16860,501646,940500
1054,884,830,1730583,16941,502476,962300
1055,883,900,1729708,16916,503376,982600
1056,848,891,1728872,16861,504267,958700
1057,885,920,1727992,16821,505187,942800
1058,870,848,1727130,16835,506035,1003000
1059,910,881,1726230,16854,506916,953800
1060,928,821,1725282,16981,507737,976700
1061,910,868,1724384,17011,508605,1126600
1062,916,971,1723464,16960,509576,970100
1063,883,913,1722567,16944,510489,984500
1064,884,864,1721670,16977,511353,981600
1065,916,880,1720762,17005,512233,964400
1066,908,861,1719890,17016,513094,952100
1067,896,831,1718960,17115,513925,966000
1068,910,903,1718051,17121,514828,959400
1069,897,878,1717155,17139,515706,940400
1070,883,879,1716275,17140,516585,964800
1071,855,919,1715432,17064,517504,953900
1072,868,884,1714553,17059,518388,980600
1073,860,912,1713690,17010,519300,945900
1074,800,854,1712896,16950,520154,957700
1075,869,858,1711996,16992,521012,969000
1076,920,893,1711101,16994,521905,1026800
1077,821,900,1710260,16935,522805,1049500
1078,843,893,1709439,16863,523698,964100
1079,838,891,1708559,16852,524589,972500
1080,853,871,1707737,16803,525460,1032500
1081,884,864,1706852,16824,526324,1099300
1082,866,888,1705995,16793,527212,983800
1083,802,830,1705184,16774,528042,973600
1084,868,852,1704333,16773,528894,1020400
1085,858,915,1703461,16730,529809,1014200
1086,855,895,1702625,16671,530704,1037000
1087,819,825,1701771,16700,531529,1039000
1088,856,868,1700926,16677,532397,1021000
1089,862,873,1700077,16653,533270,1112400
1090,882,838,1699182,16710,534108,1087500
1091,870,844,1698321,16727,534952,1056100
1092,877,892,1697473,16683,535844,1021200
1093,880,826,1696561,16769,536670,987800
1094,853,867,1695701,16762,537537,990900
1095,891,853,1694821,16789,538390,984400
1096,901,831,1693921,16858,539221,990000
1097,874,814,1693052,16913,540035,1033700
1098,814,827,1692217,16921,540862,980900
1099,870,888,1691355,16895,541750,1011400
1100,891,896,1690473,16881,542646,998500
1101,858,791,1689622,16941,543437,1013900
1102,879,829,1688742,16992,544266,1022100
1103,895,942,1687843,16949,545208,1041500
1104,905,861,1686930,17001,546069,975100
1105,867,849,1686051,17031,546918,1001800
1106,878,834,1685170,17078,547752,987500
1107,885,883,1684287,17078,548635,977200
1108,837,932,1683451,16982,549567,952600
1109,920,878,1682541,17014,550445,993600
1110,855,890,1681689,16976,551335,973100
1111,862,849,1680816,17000,552184,955800
1112,881,878,1679940,16998,553062,979200
1113,918,861,1679039,17038,553923,945600
1114,909,880,1678149,17048,554803,964000
1115,877,854,1677238,17105,555657,961800
1116,922,967,1676331,17045,556624,1207200
1117,814,863,1675504,17009,557487,1051400
1118,895,896,1674600,17017,558383,987600
1119,870,875,1673715,17027,559258,995000
1120,898,900,1672850,16992,560158,948400
1121,892,915,1671955,16972,561073,968500
1122,912,903,1671036,16988,561976,921000
1123,854,882,1670174,16968,562858,960300
1124,907,892,1669289,16961,563750,947800
1125,945,878,1668336,17036,564628,972100
1126,915,911,1667454,17007,565539,953900
1127,918,888,1666527,17046,566427,958800
1128,928,898,1665574,17101,567325,934100
1129,910,892,1664655,17128,568217,930600
1130,885,872,1663771,17140,569089,968500
1131,913,894,1662880,17137,569983,977800
1132,884,935,1661973,17109,570918,1021900
1133,922,867,1661072,17143,571785,1003800
1134,889,918,1660166,17131,572703,1020700
1135,862,895,1659305,17097,573598,970800
1136,935,862,1658382,17158,574460,942800
1137,909,883,1657491,17166,575343,976200
1138,912,891,1656568,17198,576234,955900
1139,851,906,1655693,17167,577140,942300
1140,855,922,1654839,17099,578062,962600
1141,886,919,1653980,17039,578981,937300
1142,863,897,1653105,17017,579878,954700
1143,864,926,1652231,16965,580804,1015400
1144,898,890,1651349,16957,581694,1070100
1145,847,870,1650480,16956,582564,981300
1146,899,879,1649589,16968,583443,1061100
1147,884,859,1648705,16993,584302,1124500
1148,905,893,1647813,16992,585195,1029700
1149,904,827,1646909,17069,586022,1062600
1150,889,890,1646018,17070,586912,1032100
1151,934,888,1645072,17128,587800,993200
1152,838,941,1644212,17047,588741,964500
1153,854,861,1643378,17020,589602,971200
1154,854,857,1642521,17020,590459,993000
1155,849,875,1641696,16970,591334,966700
1156,882,903,1640787,16976,592237,962600
1157,988,881,1639838,17044,593118,947100
1158,877,902,1638922,17058,594020,957700
1159,884,936,1638062,16982,594956,958900
1160,879,856,1637146,17042,595812,1019800
1161,907,836,1636273,17079,596648,958200
1162,946,866,1635334,17152,597514,1024200
1163,945,863,1634388,17235,598377,968200
1164,855,875,1633486,17262,599252,982100
1165,922,867,1632608,17273,600119,980300
1166,949,907,1631674,17300,601026,948900
1167,903,894,1630740,17340,601920,974700
1168,939,834,1629828,17418,602754,952400
1169,911,895,1628910,17441,603649,941300
1170,895,921,1628009,17421,604570,923800
1171,860,948,1627155,17327,605518,973700
1172,897,910,1626238,17334,606428,1012900
1173,895,891,1625355,17326,607319,953600
1174,882,959,1624477,17245,608278,982800
1175,958,921,1623519,17282,609199,1045400
1176,879,887,1622635,17279,610086,986300
1177,825,904,1621792,17218,610990,952700
1178,937,931,1620873,17206,611921,970800
1179,903,937,1619965,17177,612858,969900
1180,851,855,1619111,17176,613713,945600
1181,878,858,1618247,17182,614571,968400
1182,933,938,1617320,17171,615509,956100
1183,967,881,1616329,17281,616390,984700
1184,915,925,1615422,17263,617315,943800
1185,908,877,1614527,17281,618192,946200
1186,884,881,1613639,17288,619073,953100
1187,870,884,1612746,17297,619957,944900
1188,872,915,1611881,17247,620872,955300
1189,882,875,1610981,17272,621747,941300
1190,893,862,1610095,17296,622609,1090700
1191,874,871,1609236,17284,623480,991900
1192,886,935,1608364,17221,624415,968200
1193,864,829,1607508,17248,625244,997000
1194,893,862,1606574,17320,626106,1001600
1195,882,904,1605712,17278,627010,947800
1196,881,859,1604824,17307,627869,919200
1197,902,933,1603935,17263,628802,927100
1198,940,911,1603011,17276,629713,982000
1199,927,886,1602072,17329,630599,980600
1200,964,928,1601103,17370,631527,973700
1201,920,868,1600196,17409,632395,978300
1202,937,922,1599245,17438,633317,929900
1203,907,889,1598355,17439,634206,947500
1204,957,886,1597394,17514,635092,1043300
1205,931,909,1596463,17536,636001,1022600
1206,942,928,1595521,17550,636929,1053500
1207,895,975,1594595,17501,637904,986800
1208,912,949,1593686,17461,638853,1011100
1209,959,892,1592758,17497,639745,1095500
1210,948,898,1591806,17551,640643,1079200
1211,991,919,1590806,17632,641562,1038400
1212,943,932,1589865,17641,642494,1123200
1213,898,883,1588961,17662,643377,991700
1214,948,856,1588022,17745,644233,962600
1215,946,907,1587109,17751,645140,957000
1216,950,982,1586127,17751,646122,1007900
1217,873,900,1585251,17727,647022,1016900
1218,908,881,1584358,17739,647903,1053300
1219,920,942,1583407,17748,648845,1043900
1220,921,901,1582497,17757,649746,1009900
1221,927,947,1581557,17750,650693,1015300
1222,898,909,1580655,17743,651602,999500
1223,917,941,1579751,17706,652543,976800
1224,943,931,1578818,17708,653474,988900
1225,979,967,1577851,17708,654441,1020000
1226,940,885,1576903,17771,655326,1153900
1227,910,957,1575977,17740,656283,995600
1228,933,942,1575055,17720,657225,955600
1229,923,931,1574112,17732,658156,948000
1230,922,892,1573203,17749,659048,922900
1231,937,912,1572244,17796,659960,969300
1232,924,905,1571336,17799,660865,974600
1233,924,894,1570426,17815,661759,1034800
1234,922,960,1569492,17789,662719,1044600
1235,925,924,1568574,17783,663643,1011600
1236,914,907,1567650,17800,664550,1047400
1237,909,910,1566747,17793,665460,1035600
1238,892,957,1565856,17727,666417,1009900
1239,876,940,1564987,17656,667357,997900
1240,912,917,1564056,17670,668274,1005600
1241,922,946,1563144,17636,669220,993300
1242,917,918,1562257,17605,670138,1029300
1243,924,914,1561347,17601,671052,994100
1244,946,934,1560357,17657,671986,980000
1245,966,911,1559403,17700,672897,1007400
1246,917,885,1558490,17728,673782,1142900
1247,945,947,1557555,17716,674729,1049500
1248,906,973,1556628,17670,675702,1034500
1249,944,880,1555677,17741,676582,1000100
1250,934,938,1554743,17737,677520,1040700
1251,988,921,1553766,17793,678441,1021600
1252,905,899,1552864,17796,679340,990600
1253,858,888,1551991,17781,680228,991000
1254,936,991,1551081,17700,681219,1006000
1255,896,897,1550151,17733,682116,1042400
1256,953,932,1549203,17749,683048,1037100
1257,926,999,1548299,17654,684047,1019400
1258,919,923,1547385,17645,684970,1038000
1259,929,879,1546434,17717,685849,998100
1260,886,832,1545539,17780,686681,1066100
1261,901,931,1544643,17745,687612,1046200
1262,939,963,1543701,17724,688575,1011500
1263,883,945,1542833,17647,689520,1013900
1264,852,896,1541978,17606,690416,1031900
1265,844,928,1541123,17533,691344,1024300
1266,880,914,1540241,17501,692258,1028500
1267,900,924,1539351,17467,693182,1150500
1268,877,932,1538483,17403,694114,1070000
1269,813,841,1537643,17402,694955,1047500
1270,881,902,1536793,17350,695857,1114700
1271,897,878,1535879,17386,696735,1161300
1272,954,949,1534922,17394,697684,1150200
1273,893,919,1534026,17371,698603,1128300
1274,902,879,1533130,17388,699482,1077400
1275,911,957,1532235,17326,700439,1215000
1276,922,879,1531308,17374,701318,1062900
1277,928,955,1530410,17317,702273,1006700
1278,898,904,1529496,17327,703177,1087400
1279,925,890,1528544,17389,704067,1012700
1280,907,881,1527644,17408,704948,1011200
1281,933,918,1526699,17435,705866,1028700
1282,885,905,1525823,17406,706771,1007300
1283,932,931,1524907,17391,707702,980900
1284,854,907,1524035,17356,708609,948600
1285,892,910,1523150,17331,709519,994300
1286,905,877,1522266,17338,710396,954100
1287,921,940,1521329,17335,711336,1021800
1288,1004,915,1520324,17425,712251,1032400
1289,857,888,1519447,17414,713139,1058500
1290,973,898,1518519,17444,714037,977300
1291,898,879,1517614,17470,714916,1007900
1292,951,888,1516662,17534,715804,971800
1293,886,912,1515763,17521,716716,1004200
1294,919,889,1514872,17523,717605,980400
1295,876,974,1513977,17444,718579,936300
1296,874,900,1513050,17471,719479,956100
1297,903,891,1512183,17447,720370,970100
1298,986,941,1511209,17480,721311,962900
1299,859,902,1510346,17441,722213,959500
1300,901,882,1509468,17437,723095,986100
1301,925,947,1508520,17438,724042,1029600
1302,935,856,1507586,17516,724898,984100
1303,913,925,1506655,17522,725823,1025400
1304,918,953,1505761,17463,726776,979200
1305,865,870,1504869,17485,727646,953100
1306,935,909,1503935,17510,728555,958100
1307,891,964,1503070,17411,729519,990700
1308,864,902,1502171,17408,730421,1024600
1309,850,864,1501327,17388,731285,966400
1310,924,915,1500414,17386,732200,983500
1311,909,918,1499513,17369,733118,961300
1312,878,885,1498635,17362,734003,931100
1313,929,909,1497707,17381,734912,951300
1314,945,982,1496759,17347,735894,969900
1315,892,898,1495873,17335,736792,928800
1316,912,880,1494974,17354,737672,959100
1317,865,897,1494075,17356,738569,1003700
1318,953,943,1493151,17337,739512,989500
1319,925,957,1492188,17343,740469,1002300
1320,974,881,1491242,17408,741350,995600
1321,929,922,1490320,17408,742272,971800
1322,891,908,1489403,17417,743180,949700
1323,925,905,1488488,17427,744085,1026200
1324,933,878,1487571,17466,744963,963700
1325,941,884,1486622,17531,745847,975200
1326,923,904,1485712,17537,746751,954500
1327,932,906,1484754,17589,747657,980400
1328,915,870,1483859,17614,748527,1077600
1329,947,1011,1482888,17574,749538,1027100
1330,968,956,1481935,17571,750494,1022000
1331,927,963,1480989,17554,751457,1051500
1332,950,888,1480067,17588,752345,1171700
1333,939,927,1479095,17633,753272,1376200
1334,923,923,1478200,17605,754195,1063700
1335,956,865,1477231,17709,755060,1030900
1336,982,863,1476262,17815,755923,1320700
1337,932,936,1475312,17829,756859,1180400
1338,920,915,1474371,17855,757774,1133800
1339,922,916,1473492,17818,758690,1055700
1340,936,883,1472548,17879,759573,1090600
1341,937,909,1471603,17915,760482,1119200
1342,958,927,1470638,17953,761409,1112200
1343,944,879,1469712,18000,762288,1068100
1344,928,872,1468803,18037,763160,1107800
1345,1003,960,1467769,18111,764120,1195300
1346,881,950,1466890,18040,765070,1097500
1347,910,893,1465978,18059,765963,1155500
1348,950,885,1465056,18096,766848,1129600
1349,939,954,1464113,18085,767802,1143900
1350,900,951,1463169,18078,768753,1153400
1351,903,1029,1462269,17949,769782,1104700
1352,885,989,1461400,17829,770771,1103800
1353,890,893,1460531,17805,771664,1125800
1354,877,901,1459626,17809,772565,1103000
1355,925,971,1458734,17730,773536,1121100
1356,870,869,1457829,17766,774405,1031100
1357,928,983,1456915,17697,775388,1021900
1358,896,926,1456015,17671,776314,1126600
1359,959,912,1455074,17700,777226,1117900
1360,959,942,1454107,17725,778168,1094900
1361,921,894,1453157,17781,779062,1113500
1362,926,917,1452263,17758,779979,1126100
1363,951,895,1451323,17803,780874,1182100
1364,880,912,1450429,17785,781786,1112800
1365,937,869,1449486,17859,782655,1124800
1366,919,994,1448573,17778,783649,1116500
1367,867,956,1447684,17711,784605,1083100
1368,904,880,1446786,17729,785485,1140900
1369,960,960,1445840,17715,786445,1130400
1370,916,898,1444915,17742,787343,1080800
1371,882,923,1444038,17696,788266,1181400
1372,866,941,1443168,17625,789207,1306900
1373,894,936,1442284,17573,790143,1151800
1374,915,934,1441380,17543,791077,1145200
1375,890,899,1440459,17565,791976,1110200
1376,893,900,1439591,17533,792876,1123300
1377,916,946,1438683,17495,793822,1067900
1378,933,869,1437749,17560,794691,1015600
1379,922,907,1436836,17566,795598,1010800
1380,968,874,1435853,17675,796472,1031400
1381,907,884,1434930,17714,797356,1013000
1382,979,914,1433957,17773,798270,1004600
1383,897,946,1433045,17739,799216,961600
1384,935,946,1432136,17702,800162,994100
1385,944,891,1431187,17760,801053,1022200
1386,942,910,1430237,17800,801963,1088400
1387,914,918,1429328,17791,802881,1100200
1388,918,894,1428413,17812,803775,1021500
1389,1009,913,1427397,17915,804688,1017000
1390,918,982,1426489,17841,805670,1031000
1391,948,911,1425495,17924,806581,1084700
1392,968,963,1424587,17869,807544,1158000
1393,926,975,1423617,17864,808519,1106200
1394,914,973,1422742,17766,809492,1049600
1395,946,890,1421775,17843,810382,1015300
1396,981,911,1420834,17873,811293,992000
1397,895,947,1419887,17873,812240,1102100
1398,1023,879,1418895,17986,813119,1069700
1399,972,948,1417904,18029,814067,1042600
1400,925,911,1416996,18026,814978,1052700
1401,956,899,1416013,18110,815877,1026100
1402,974,897,1415060,18166,816774,986400
1403,922,921,1414157,18148,817695,988200
1404,1007,993,1413140,18172,818688,969000
1405,965,913,1412158,18241,819601,988800
1406,942,872,1411231,18296,820473,967000
1407,946,965,1410279,18283,821438,1051600
1408,933,965,1409333,18264,822403,1026500
1409,925,992,1408425,18180,823395,975000
1410,993,918,1407422,18265,824313,970600
1411,948,913,1406470,18304,825226,995000
1412,920,905,1405546,18323,826131,990900
1413,960,974,1404593,18302,827105,970300
1414,929,1039,1403652,18204,828144,1035200
1415,923,981,1402722,18153,829125,1094200
1416,933,922,1401820,18133,830047,990900
1417,937,942,1400848,18163,830989,1035900
1418,998,935,1399870,18206,831924,991800
1419,914,972,1398942,18162,832896,965700
1420,975,910,1398007,18187,833806,990800
1421,872,976,1397100,18118,834782,978300
1422,938,947,1396196,18075,835729,962100
1423,915,971,1395255,18045,836700,960300
1424,966,938,1394311,18051,837638,972600
1425,915,963,1393379,18020,838601,962700
1426,868,914,1392507,17978,839515,989000
1427,876,901,1391623,17961,840416,1001300
1428,896,955,1390736,17893,841371,954200
1429,890,926,1389835,17868,842297,951600
1430,870,935,1388979,17789,843232,996900
1431,945,862,1388065,17841,844094,1037000
1432,842,952,1387197,17757,845046,1017000
1433,877,919,1386313,17722,845965,985400
1434,908,931,1385408,17696,846896,981300
1435,913,916,1384482,17706,847812,987300
1436,936,927,1383538,17723,848739,1013500
1437,958,920,1382612,17729,849659,983100
1438,906,922,1381683,17736,850581,955600
1439,880,913,1380778,17728,851494,962300
1440,901,910,1379909,17687,852404,963000
1441,903,902,1379005,17689,853306,953900
1442,928,926,1378076,17692,854232,983900
1443,905,907,1377159,17702,855139,978700
1444,883,867,1376262,17732,856006,944600
1445,915,912,1375349,17733,856918,982500
1446,967,881,1374437,17764,857799,1027400
1447,912,953,1373496,17752,858752,991000
1448,896,935,1372611,17702,859687,936900
1449,913,917,1371667,17729,860604,960900
1450,885,965,1370773,17658,861569,984000
1451,924,965,1369854,17612,862534,1067500
1452,901,860,1368971,17635,863394,984900
1453,908,826,1368055,17725,864220,970800
1454,888,946,1367181,17653,865166,982400
1455,877,902,1366317,17615,866068,1015000
1456,898,918,1365398,17616,866986,1096500
1457,913,913,1364476,17625,867899,1083500
1458,891,959,1363595,17547,868858,1029100
1459,848,866,1362724,17552,869724,1043000
1460,882,915,1361844,17517,870639,1057300
1461,858,886,1360991,17484,871525,1075000
1462,864,908,1360142,17425,872433,1002600
1463,865,826,1359265,17476,873259,967000
1464,975,872,1358321,17548,874131,980200
1465,820,928,1357483,17458,875059,1038600
1466,884,926,1356592,17423,875985,1002900
1467,834,915,1355761,17339,876900,978400
1468,946,905,1354828,17367,877805,952500
1469,862,877,1353964,17354,878682,968000
1470,924,886,1353048,17384,879568,968200
1471,863,877,1352166,17389,880445,974700
1472,832,843,1351312,17400,881288,963500
1473,880,885,1350456,17371,882173,959100
1474,854,904,1349583,17340,883077,973100
1475,891,938,1348713,17272,884015,1061700
1476,895,891,1347851,17243,884906,1056400
1477,958,892,1346896,17306,885798,1096100
1478,931,892,1345945,17365,886690,990600
1479,881,870,1345049,17391,887560,979100
1480,947,925,1344122,17393,888485,945300
1481,863,907,1343241,17367,889392,941700
1482,914,909,1342340,17359,890301,984000
1483,937,827,1341410,17462,891128,994600
1484,858,905,1340529,17438,892033,996200
1485,907,863,1339631,17473,892896,1033400
1486,906,951,1338722,17431,893847,988800
1487,943,888,1337781,17484,894735,981500
1488,849,927,1336930,17408,895662,1037700
1489,880,884,1336034,17420,896546,973500
1490,868,892,1335168,17394,897438,986900
1491,891,923,1334270,17369,898361,1050900
1492,942,953,1333348,17338,899314,998700
1493,856,852,1332478,17356,900166,1013200
1494,865,917,1331651,17266,901083,1010600
1495,879,955,1330705,17257,902038,1028100
1496,843,894,1329897,17171,902932,957300
1497,905,932,1328962,17174,903864,933000
1498,860,868,1328138,17130,904732,944500
1499,894,882,1327225,17161,905614,965000
1500,915,896,1326323,17167,906510,938500
1501,895,869,1325435,17186,907379,977700
1502,934,852,1324491,17278,908231,949700
1503,912,901,1323594,17274,909132,930900
1504,838,908,1322725,17235,910040,974700
1505,885,848,1321862,17250,910888,968000
1506,942,883,1320943,17286,911771,1005200
1507,930,855,1320008,17366,912626,1041400
1508,953,848,1319059,17467,913474,991300
1509,922,913,1318110,17503,914387,986800
1510,905,903,1317227,17483,915290,955600
1511,955,924,1316271,17515,916214,940000
1512,922,955,1315348,17483,917169,955400
1513,906,863,1314426,17542,918032,941300
1514,893,892,1313550,17526,918924,951100
1515,1003,920,1312563,17593,919844,997400
1516,1002,904,1311564,17688,920748,1161000
1517,903,910,1310627,17715,921658,1007800
1518,969,911,1309651,17780,922569,1021300
1519,970,927,1308693,17811,923496,990000
1520,950,903,1307748,17853,924399,1024800
1521,941,966,1306799,17836,925365,1072800
1522,868,891,1305922,17822,926256,1129300
1523,924,940,1305029,17775,927196,1062100
1524,934,939,1304072,17793,928135,1051600
1525,930,914,1303158,17793,929049,1009400
1526,935,909,1302221,17821,929958,1045000
1527,874,1018,1301308,17716,930976,971100
1528,880,918,1300451,17655,931894,980600
1529,945,933,1299521,17652,932827,971300
1530,907,899,1298608,17666,933726,946700
1531,884,862,1297713,17699,934588,947100
1532,902,859,1296811,17742,935447,975300
1533,901,883,1295929,17741,936330,963900
1534,846,911,1295062,17697,937241,997400
1535,924,928,1294142,17689,938169,970000
1536,909,944,1293243,17644,939113,1007200
1537,942,912,1292301,17674,940025,1000200
1538,900,898,1291390,17687,940923,988000
1539,857,898,1290543,17636,941821,968300
1540,896,967,1289639,17573,942788,961500
1541,886,943,1288751,17518,943731,949400
1542,902,913,1287866,17490,944644,940400
1543,917,865,1286967,17524,945509,953800
1544,845,912,1286084,17495,946421,991800
1545,817,960,1285279,17340,947381,954900
1546,900,904,1284390,17325,948285,948900
1547,862,928,1283499,17288,949213,963600
1548,851,877,1282654,17256,950090,964200
1549,827,888,1281806,17216,950978,958800
1550,834,859,1280976,17187,951837,953700
1551,840,925,1280135,17103,952762,950000
1552,899,909,1279256,17073,953671,1060100
1553,899,915,1278357,17057,954586,1070200
1554,849,913,1277502,16999,955499,1082900
1555,841,919,1276650,16932,956418,998600
1556,808,927,1275842,16813,957345,958500
1557,870,869,1275011,16775,958214,961300
1558,854,863,1274159,16764,959077,947800
1559,833,917,1273274,16732,959994,962100
1560,848,892,1272444,16670,960886,942300
1561,850,887,1271595,16632,961773,923200
1562,825,908,1270769,16550,962681,965400
1563,884,835,1269889,16595,963516,939300
1564,852,832,1269021,16631,964348,1000800
1565,847,875,1268183,16594,965223,949800
1566,866,860,1267312,16605,966083,947800
1567,866,858,1266456,16603,966941,963000
1568,894,817,1265572,16670,967758,979900
1569,888,874,1264679,16689,968632,998300
1570,795,839,1263861,16668,969471,984300
1571,808,881,1263084,16564,970352,979600
1572,862,856,1262210,16582,971208,948600
1573,847,833,1261391,16568,972041,1011000
1574,840,837,1260523,16599,972878,998600
1575,837,888,1259678,16556,973766,966900
1576,797,878,1258904,16452,974644,957100
1577,811,871,1258068,16417,975515,945800
1578,758,851,1257297,16337,976366,950400
1579,839,776,1256468,16390,977142,947000
1580,853,880,1255638,16340,978022,954100
1581,805,859,1254820,16299,978881,1079200
1582,863,903,1253955,16261,979784,1017400
1583,832,821,1253133,16262,980605,1001700
1584,883,831,1252217,16347,981436,1103800
1585,876,817,1251364,16383,982253,1066800
1586,847,846,1250531,16370,983099,1059700
1587,824,874,1249705,16322,983973,1105900
1588,836,830,1248841,16356,984803,1040500
1589,841,830,1248026,16341,985633,992600
1590,842,873,1247157,16337,986506,1015300
1591,824,829,1246356,16309,987335,1007900
1592,839,780,1245475,16410,988115,1000900
1593,852,868,1244672,16345,988983,1019400
1594,821,901,1243830,16286,989884,995700
1595,804,838,1243030,16248,990722,982800
1596,807,870,1242223,16185,991592,953500
1597,754,818,1241465,16125,992410,969700
1598,775,830,1240694,16066,993240,957100
1599,808,836,1239877,16047,994076,965500
1600,851,807,1239043,16074,994883,1066900
1601,878,828,1238167,16122,995711,1011700
1602,834,859,1237333,16097,996570,1196700
1603,826,835,1236517,16078,997405,1070200
1604,864,818,1235636,16141,998223,997400
1605,818,800,1234835,16142,999023,1021500
1606,806,862,1234020,16095,999885,995300
1607,816,875,1233213,16027,1000760,965100
1608,799,874,1232376,15990,1001634,986700
1609,830,820,1231563,15983,1002454,962700
1610,899,859,1230678,16009,1003313,957200
1611,837,866,1229832,15989,1004179,934500
1612,827,892,1229013,15916,1005071,950800
1613,878,870,1228161,15898,1005941,995200
1614,808,824,1227312,15923,1006765,962500
1615,838,825,1226470,15940,1007590,1020100
1616,862,878,1225647,15885,1008468,1013000
1617,831,841,1224791,15900,1009309,1035700
1618,882,842,1223917,15932,1010151,966700
1619,822,847,1223100,15902,1010998,10183300
1620,868,823,1222228,15951,1011821,1527200
1621,830,852,1221388,15939,1012673,1413500
1622,809,792,1220569,15966,1013465,1262700
1623,791,804,1219769,15962,1014269,1185900
1624,828,816,1218971,15944,1015085,1105200
1625,858,798,1218058,16059,1015883,1078600
1626,878,848,1217228,16041,1016731,1020800
1627,778,862,1216410,15997,1017593,995200
1628,835,787,1215600,16020,1018380,980000
1629,869,801,1214726,16093,1019181,980200
1630,847,826,1213897,16096,1020007,967300
1631,847,857,1213038,16098,1020864,976300
1632,805,863,1212238,16035,1021727,1013800
1633,822,855,1211424,15994,1022582,989500
1634,833,813,1210592,16013,1023395,995100
1635,855,842,1209747,16016,1024237,1020000
1636,756,787,1208931,16045,1025024,1082200
1637,777,845,1208193,15938,1025869,980000
1638,789,796,1207398,15937,1026665,984600
1639,808,844,1206614,15877,1027509,988800
1640,831,801,1205797,15893,1028310,1032900
1641,839,820,1204931,15939,1029130,1054100
1642,809,853,1204093,15924,1029983,1108300
1643,820,826,1203303,15888,1030809,1069700
1644,815,876,1202497,15818,1031685,1049200
1645,775,848,1201708,15759,1032533,994200
1646,863,834,1200841,15792,1033367,997900
1647,793,829,1200049,15755,1034196,982600
1648,835,786,1199222,15796,1034982,994800
1649,820,831,1198403,15784,1035813,957400
1650,795,844,1197582,15761,1036657,987500
1651,832,828,1196775,15740,1037485,1029500
1652,829,805,1195924,15786,1038290,1035200
1653,843,829,1195089,15792,1039119,961900
1654,891,847,1194229,15805,1039966,980800
1655,814,845,1193408,15781,1040811,947900
1656,881,790,1192535,15864,1041601,980200
1657,854,830,1191677,15892,1042431,947700
1658,805,864,1190844,15861,1043295,1022300
1659,861,811,1189998,15896,1044106,972400
1660,806,835,1189183,15876,1044941,1002900
1661,824,801,1188371,15887,1045742,988700
1662,756,828,1187613,15817,1046570,1036200
1663,795,834,1186822,15774,1047404,964300
1664,780,857,1186039,15700,1048261,990500
1665,743,795,1185280,15664,1049056,994200
1666,787,801,1184507,15636,1049857,1030400
1667,787,839,1183712,15592,1050696,976300
1668,746,846,1182950,15508,1051542,966100
1669,751,866,1182192,15400,1052408,958600
1670,828,776,1181391,15425,1053184,959800
1671,817,801,1180597,15418,1053985,968500
1672,757,831,1179792,15392,1054816,1006200
1673,750,764,1179047,15373,1055580,962100
1674,769,783,1178295,15342,1056363,1004000
1675,761,744,1177523,15370,1057107,987200
1676,741,813,1176787,15293,1057920,987900
1677,779,788,1176008,15284,1058708,935800
1678,769,774,1175250,15268,1059482,1002200
1679,760,801,1174489,15228,1060283,982700
1680,796,770,1173671,15276,1061053,968800
1681,727,815,1172949,15183,1061868,966400
1682,717,735,1172215,15182,1062603,1091900
1683,811,760,1171443,15194,1063363,1023600
1684,802,778,1170617,15242,1064141,962900
1685,786,834,1169798,15227,1064975,994600
1686,740,758,1169095,15172,1065733,999600
1687,780,858,1168311,15098,1066591,978200
1688,776,738,1167518,15153,1067329,1028100
1689,794,793,1166731,15147,1068122,990000
1690,723,790,1166014,15074,1068912,988300
1691,791,800,1165225,15063,1069712,1011400
1692,835,817,1164421,15050,1070529,1031800
1693,833,744,1163573,15154,1071273,1002300
1694,814,797,1162780,15150,1072070,975600
1695,794,814,1161958,15158,1072884,970000
1696,763,821,1161180,15115,1073705,990900
1697,758,752,1160435,15108,1074457,1044900
1698,802,750,1159648,15145,1075207,1035300
1699,811,759,1158818,15216,1075966,992800
1700,805,802,1158033,15199,1076768,977900
1701,822,763,1157224,15245,1077531,996000
1702,763,804,1156429,15236,1078335,1128900
1703,797,793,1155642,15230,1079128,1012500
1704,794,779,1154837,15256,1079907,1051800
1705,765,868,1154067,15158,1080775,1048700
1706,761,766,1153297,15162,1081541,1044100
1707,775,831,1152531,15097,1082372,1099600
1708,769,794,1151772,15062,1083166,1151400
1709,786,741,1150968,15125,1083907,1022100
1710,805,824,1150190,15079,1084731,1073300
1711,796,813,1149387,15069,1085544,1035700
1712,775,817,1148603,15036,1086361,1072400
1713,781,764,1147820,15055,1087125,1277800
1714,758,785,1147063,15027,1087910,1040700
1715,749,812,1146304,14974,1088722,1003100
1716,705,784,1145584,14910,1089506,964000
1717,716,774,1144887,14833,1090280,979100
1718,708,757,1144186,14777,1091037,978100
1719,716,756,1143465,14742,1091793,1013900
1720,758,733,1142713,14761,1092526,1028200
1721,705,804,1141985,14685,1093330,1048100
1722,676,736,1141306,14628,1094066,960800
1723,763,749,1140585,14600,1094815,1015600
1724,743,746,1139806,14633,1095561,975300
1725,781,748,1139042,14649,1096309,990700
1726,718,771,1138316,14604,1097080,1002400
1727,729,748,1137592,14580,1097828,1072200
1728,719,728,1136876,14568,1098556,1071500
1729,687,739,1136170,14535,1099295,1020900
1730,740,743,1135458,14504,1100038,981800
1731,749,828,1134693,14441,1100866,1077800
1732,683,751,1134025,14358,1101617,970500
1733,731,774,1133300,14309,1102391,972900
1734,715,758,1132575,14276,1103149,955500
1735,769,767,1131810,14274,1103916,996900
1736,725,757,1131075,14252,1104673,1070800
1737,764,802,1130296,14229,1105475,1052700
1738,785,705,1129520,14300,1106180,1052300
1739,745,762,1128777,14281,1106942,1025300
1740,743,740,1128037,14281,1107682,1009900
1741,778,741,1127280,14297,1108423,1044300
1742,716,767,1126531,14279,1109190,1022300
1743,785,765,1125770,14275,1109955,1082500
1744,703,733,1125034,14278,1110688,998700
1745,771,761,1124291,14260,1111449,1017600
1746,709,801,1123572,14178,1112250,1030200
1747,755,714,1122822,14214,1112964,1048700
1748,725,748,1122103,14185,1113712,1053200
1749,778,713,1121330,14245,1114425,1202100
1750,738,737,1120582,14256,1115162,1078200
1751,751,750,1119820,14268,1115912,1021400
1752,734,758,1119110,14220,1116670,1000100
1753,754,772,1118360,14198,1117442,1012900
1754,761,747,1117566,14245,1118189,981700
1755,774,752,1116814,14245,1118941,963500
1756,711,728,1116080,14251,1119669,997700
1757,750,741,1115342,14248,1120410,1024300
1758,737,703,1114607,14280,1121113,987600
1759,741,744,1113861,14282,1121857,981700
1760,797,740,1113090,14313,1122597,998100
1761,762,740,1112333,14330,1123337,991700
1762,747,746,1111554,14363,1124083,1030100
1763,765,692,1110786,14439,1124775,1075400
1764,765,725,1110045,14455,1125500,986400
1765,719,747,1109299,14454,1126247,1101000
1766,750,740,1108562,14451,1126987,995400
1767,791,706,1107774,14533,1127693,1001700
1768,801,754,1106981,14572,1128447,1068500
1769,784,751,1106204,14598,1129198,1087100
1770,758,751,1105437,14614,1129949,1130100
1771,769,786,1104671,14594,1130735,1048400
1772,786,746,1103882,14637,1131481,1213500
1773,771,750,1103111,14658,1132231,1050300
1774,779,734,1102352,14683,1132965,1076400
1775,790,719,1101551,14765,1133684,1030900
1776,811,796,1100733,14787,1134480,1042700
1777,765,793,1099977,14750,1135273,1004800
1778,780,767,1099194,14766,1136040,1030100
1779,824,777,1098367,14816,1136817,1041800
1780,813,784,1097573,14826,1137601,1021900
1781,756,795,1096793,14811,1138396,1024500
1782,785,772,1096014,14818,1139168,970000
1783,771,729,1095241,14862,1139897,994400
1784,780,774,1094482,14847,1140671,982000
1785,758,791,1093687,14851,1141462,1003500
1786,781,751,1092921,14866,1142213,996800
1787,781,727,1092112,14948,1142940,1131000
1788,735,760,1091408,14892,1143700,1179000
1789,791,761,1090601,14938,1144461,1044600
1790,771,795,1089839,14905,1145256,1007300
1791,774,758,1089059,14927,1146014,999600
1792,841,751,1088212,15023,1146765,983300
1793,773,742,1087445,15048,1147507,995100
1794,778,765,1086656,15072,1148272,968300
1795,775,814,1085904,15010,1149086,1005300
1796,787,746,1085108,15060,1149832,1021700
1797,738,788,1084366,15014,1150620,995500
1798,808,777,1083553,15050,1151397,1033400
1799,802,791,1082763,15049,1152188,1008600
1800,687,787,1082038,14987,1152975,979500
1801,821,761,1081258,15006,1153736,1069000
1802,791,728,1080466,15070,1154464,1006100
1803,755,766,1079728,15042,1155230,1093000
1804,752,771,1078947,15052,1156001,1063800
1805,739,798,1078221,14980,1156799,1000700
1806,786,746,1077443,15012,1157545,1010200
1807,787,751,1076654,15050,1158296,1006300
1808,759,783,1075870,15051,1159079,1043500
1809,783,761,1075123,15037,1159840,1022900
1810,842,760,1074275,15125,1160600,997200
1811,773,784,1073486,15130,1161384,996100
1812,795,770,1072690,15156,1162154,993200
1813,780,807,1071919,15120,1162961,1023300
1814,809,772,1071121,15146,1163733,997000
1815,867,799,1070233,15235,1164532,987600
1816,834,786,1069399,15283,1165318,989300
1817,820,808,1068593,15281,1166126,1097500
1818,801,830,1067800,15244,1166956,1030400
1819,785,823,1067006,15215,1167779,1016400
1820,724,784,1066277,15160,1168563,987500
1821,714,810,1065573,15054,1169373,1037100
1822,777,773,1064791,15063,1170146,974000
1823,763,796,1064041,15017,1170942,990800
1824,738,774,1063273,15011,1171716,992500
1825,765,774,1062518,14992,1172490,1018400
1826,725,802,1061789,14919,1173292,1001100
1827,713,768,1061093,14847,1174060,1057100
1828,789,750,1060300,14890,1174810,1028000
1829,698,701,1059571,14918,1175511,1026200
1830,777,797,1058817,14875,1176308,1085400
1831,742,729,1058072,14891,1177037,1051400
1832,750,758,1057333,14872,1177795,1029100
1833,733,751,1056577,14877,1178546,1421900
1834,730,806,1055851,14797,1179352,1215400
1835,759,674,1055106,14868,1180026,1132100
1836,786,780,1054325,14869,1180806,1089300
1837,755,776,1053564,14854,1181582,1071400
1838,733,760,1052824,14834,1182342,1158300
1839,744,780,1052089,14789,1183122,1056800
1840,748,766,1051342,14770,1183888,1010000
1841,780,753,1050543,14816,1184641,964400
1842,782,784,1049775,14800,1185425,1020400
1843,720,770,1049036,14769,1186195,1039300
1844,732,789,1048301,14715,1186984,1010900
1845,738,734,1047562,14720,1187718,1045000
1846,765,763,1046841,14678,1188481,1021500
1847,738,723,1046058,14738,1189204,1027000
1848,765,776,1045326,14694,1189980,1024000
1849,726,781,1044577,14662,1190761,1020900
1850,714,741,1043865,14633,1191502,1017000
1851,778,772,1043094,14632,1192274,1017200
1852,697,765,1042401,14560,1193039,990200
1853,703,709,1041679,14573,1193748,998100
1854,752,706,1040951,14595,1194454,997100
1855,689,763,1040227,14556,1195217,1059200
1856,716,775,1039521,14487,1195992,1000300
1857,727,750,1038821,14437,1196742,987800
1858,737,754,1038058,14446,1197496,1022900
1859,763,797,1037319,14388,1198293,977000
1860,717,736,1036587,14384,1199029,986000
1861,689,712,1035888,14371,1199741,985400
1862,753,729,1035163,14367,1200470,982600
1863,768,700,1034374,14456,1201170,1066400
1864,661,727,1033715,14388,1201897,1028100
1865,715,729,1032987,14387,1202626,1035500
1866,727,753,1032293,14328,1203379,1024300
1867,713,724,1031546,14351,1204103,1023300
1868,698,762,1030867,14268,1204865,1029500
1869,721,770,1030128,14237,1205635,993300
1870,726,741,1029428,14196,1206376,1036800
1871,718,747,1028692,14185,1207123,1020900
1872,729,719,1027956,14202,1207842,993700
1873,714,716,1027258,14184,1208558,989500
1874,683,713,1026566,14163,1209271,1028200
1875,685,683,1025880,14166,1209954,1068100
1876,708,711,1025178,14157,1210665,995100
1877,683,743,1024493,14099,1211408,991900
1878,693,757,1023778,14057,1212165,1039600
1879,745,724,1023062,14049,1212889,1008200
1880,693,734,1022344,14033,1213623,1018600
1881,734,725,1021640,14012,1214348,1000300
1882,702,716,1020917,14019,1215064,990100
1883,660,709,1020267,13960,1215773,978000
1884,731,719,1019546,13962,1216492,1032600
1885,700,719,1018831,13958,1217211,1019100
1886,713,726,1018124,13939,1217937,985200
1887,721,711,1017402,13950,1218648,990100
1888,719,715,1016669,13968,1219363,998700
1889,702,701,1015978,13958,1220064,1021600
1890,750,761,1015218,13957,1220825,1016400
1891,752,671,1014482,14022,1221496,1052400
1892,697,737,1013770,13997,1222233,1092200
1893,746,722,1013040,14005,1222955,1097000
1894,718,704,1012353,13988,1223659,1253000
1895,717,752,1011600,13989,1224411,1315400
1896,731,755,1010884,13950,1225166,1227300
1897,742,692,1010127,14015,1225858,1190900
1898,722,679,1009399,14064,1226537,1087200
1899,710,731,1008716,14016,1227268,1076800
1900,746,770,1007936,14026,1228038,1098800
1901,733,701,1007222,14039,1228739,1096600
1902,705,691,1006502,14068,1229430,1074200
1903,741,748,1005784,14038,1230178,1055600
1904,754,733,1005041,14048,1230911,1060000
1905,710,745,1004290,14054,1231656,1036100
1906,790,781,1003533,14030,1232437,1057200
1907,655,692,1002856,14015,1233129,1040200
1908,646,715,1002199,13957,1233844,1067900
1909,682,731,1001520,13905,1234575,1018200
1910,667,713,1000866,13846,1235288,1038600
1911,699,717,1000194,13801,1236005,1101700
1912,679,681,999477,13837,1236686,1072300
1913,702,726,998803,13785,1237412,1065000
1914,677,692,998102,13794,1238104,1069900
1915,701,714,997410,13772,1238818,1042200
1916,715,726,996707,13749,1239544,1044400
1917,694,728,995992,13736,1240272,1088200
1918,660,704,995345,13679,1240976,1030500
1919,715,697,994625,13702,1241673,1025800
1920,704,692,993941,13694,1242365,1061200
1921,686,716,993208,13711,1243081,1030700
1922,681,707,992541,13671,1243788,1131000
1923,662,703,991894,13615,1244491,1121000
1924,643,690,991233,13586,1245181,1093700
1925,699,755,990562,13502,1245936,1147100
1926,690,713,989864,13487,1246649,1140400
1927,718,737,989146,13468,1247386,1123700
1928,685,716,988434,13464,1248102,1159700
1929,685,666,987759,13473,1248768,1155300
1930,681,686,987075,13471,1249454,1189400
1931,728,677,986378,13491,1250131,1149000
1932,697,741,985656,13472,1250872,1309600
1933,680,737,984970,13421,1251609,1323700
1934,733,673,984248,13470,1252282,1335900
1935,695,710,983548,13460,1252992,1317300
1936,653,676,982884,13448,1253668,1469200
1937,715,631,982183,13518,1254299,1315600
1938,695,759,981500,13442,1255058,1360500
1939,648,714,980856,13372,1255772,1336700
1940,682,701,980170,13357,1256473,1315800
1941,694,690,979487,13350,1257163,1153400
1942,699,698,978772,13367,1257861,1095300
1943,705,677,978069,13393,1258538,1172500
1944,639,721,977414,13327,1259259,1211700
1945,710,708,976707,13326,1259967,1146100
1946,681,687,976012,13334,1260654,1068900
1947,651,713,975344,13289,1261367,1054400
1948,650,676,974726,13231,1262043,1083000
1949,665,664,974058,13235,1262707,1117900
1950,646,653,973427,13213,1263360,1045200
1951,656,633,972742,13265,1263993,1080100
1952,627,699,972118,13190,1264692,1046100
1953,629,676,971476,13156,1265368,1148400
1954,665,688,970821,13123,1266056,1070400
1955,625,653,970211,13080,1266709,1105600
1956,699,667,969528,13096,1267376,1114100
1957,649,693,968868,13063,1268069,1059500
1958,629,682,968236,13013,1268751,1198700
1959,729,668,967509,13072,1269419,1026700
1960,711,689,966790,13102,1270108,1023200
1961,689,715,966106,13071,1270823,1028500
1962,635,651,965453,13073,1271474,1115800
1963,716,704,964751,13071,1272178,1065800
1964,710,684,964050,13088,1272862,1084800
1965,664,679,963395,13064,1273541,1046700
1966,650,725,962711,13023,1274266,1018700
1967,653,685,962058,12991,1274951,1004300
1968,654,655,961434,12960,1275606,976100
1969,642,695,960757,12942,1276301,1015200
1970,703,633,960071,12995,1276934,990400
1971,647,708,959434,12924,1277642,975200
1972,636,636,958792,12930,1278278,1029300
1973,637,622,958167,12933,1278900,1048300
1974,657,702,957491,12907,1279602,1045800
1975,636,676,956857,12865,1280278,968700
1976,632,648,956215,12859,1280926,1027900
1977,652,658,955567,12849,1281584,1024200
1978,619,645,954960,12811,1282229,1070100
1979,631,654,954318,12799,1282883,1072000
1980,626,650,953704,12763,1283533,1037300
1981,634,670,953067,12730,1284203,970200
1982,663,682,952393,12722,1284885,993000
1983,596,636,951799,12680,1285521,2035000
1984,635,671,951175,12633,1286192,1112400
1985,642,645,950513,12650,1286837,1008000
1986,642,629,949874,12660,1287466,1035200
1987,615,659,949247,12628,1288125,976800
1988,602,669,948664,12542,1288794,965300
1989,656,653,947999,12554,1289447,1040300
1990,578,691,947413,12449,1290138,1031000
1991,614,652,946818,12392,1290790,1030300
1992,606,648,946195,12367,1291438,1013700
1993,624,603,945570,12389,1292041,1043500
1994,661,645,944963,12351,1292686,1023800
1995,574,688,944339,12287,1293374,1011700
1996,650,603,943708,12315,1293977,1044600
1997,638,657,943071,12295,1294634,977800
1998,601,626,942454,12286,1295260,971700
1999,613,618,941827,12295,1295878,1023700
2000,687,611,941173,12338,1296489,1011000
2001,592,661,940576,12274,1297150,1025100
2002,644,616,939950,12284,1297766,994600
2003,656,626,939263,12345,1298392,972500
2004,646,618,938605,12385,1299010,977500
2005,623,652,937996,12342,1299662,1006000
2006,599,691,937399,12248,1300353,1010200
2007,626,671,936780,12196,1301024,974800
2008,636,651,936169,12156,1301675,1021200
2009,670,651,935473,12201,1302326,970400
2010,677,628,934794,12252,1302954,999300
2011,718,630,934084,12332,1303584,976400
2012,695,645,933403,12368,1304229,1042600
2013,696,678,932709,12384,1304907,1008000
2014,655,676,932041,12376,1305583,1000600
2015,619,667,931413,12337,1306250,1044200
2016,634,655,930791,12304,1306905,1112200
2017,663,633,930110,12352,1307538,1020400
2018,662,657,929451,12354,1308195,1028400
2019,644,639,928801,12365,1308834,1115300
2020,639,652,928166,12348,1309486,1154100
2021,644,626,927522,12366,1310112,1198300
2022,660,601,926868,12419,1310713,1066900
2023,666,651,926203,12433,1311364,1048500
2024,615,659,925586,12391,1312023,1050900
2025,625,664,924956,12357,1312687,1017700
2026,648,649,924317,12347,1313336,1019800
2027,590,621,923717,12326,1313957,1067700
2028,637,615,923088,12340,1314572,1046500
2029,656,638,922426,12364,1315210,1018800
2030,616,638,921819,12333,1315848,982000
2031,571,637,921230,12285,1316485,1046700
2032,577,619,920648,12248,1317104,976200
2033,552,605,920091,12200,1317709,977700
2034,652,626,919465,12200,1318335,962400
2035,601,657,918854,12154,1318992,969800
2036,660,654,918210,12144,1319646,999700
2037,654,648,917551,12155,1320294,1053200
2038,615,649,916937,12120,1320943,1002400
2039,567,635,916346,12076,1321578,989800
2040,616,637,915748,12037,1322215,962100
2041,625,584,915113,12088,1322799,1013400
2042,619,614,914490,12097,1323413,977900
2043,607,601,913889,12097,1324014,980900
2044,630,628,913250,12108,1324642,989700
2045,602,596,912675,12087,1325238,998600
2046,614,640,912048,12074,1325878,954000
2047,614,642,911407,12073,1326520,988000
2048,648,639,910798,12043,1327159,956300
2049,567,628,910211,12002,1327787,923600
2050,649,628,909600,11985,1328415,943100
2051,665,654,908920,12011,1329069,999100
2052,624,615,908280,12036,1329684,990400
2053,624,621,907650,12045,1330305,994300
2054,577,594,907052,12049,1330899,962400
2055,602,604,906462,12035,1331503,996200
2056,596,591,905868,12038,1332094,975300
2057,618,640,905274,11992,1332734,972000
2058,636,615,904631,12020,1333349,969100
2059,656,638,903984,12029,1333987,982200
2060,619,629,903352,12032,1334616,1005600
2061,589,633,902764,11987,1335249,1051300
2062,572,605,902173,11973,1335854,1008900
2063,604,625,901583,11938,1336479,995900
2064,618,574,900962,11985,1337053,960700
2065,647,624,900336,11987,1337677,969400
2066,623,624,899707,11992,1338301,945800
2067,618,632,899084,11983,1338933,960700
2068,581,591,898478,11998,1339524,1012700
2069,612,617,897900,11959,1340141,1004300
2070,587,571,897306,11982,1340712,963300
2071,601,579,896698,12011,1341291,993500
2072,608,646,896090,11973,1341937,996300
2073,634,566,895464,12033,1342503,969200
2074,600,653,894838,12006,1343156,991700
2075,595,598,894250,11996,1343754,975400
2076,581,650,893680,11916,1344404,951900
2077,598,621,893077,11898,1345025,985700
2078,587,627,892487,11861,1345652,949900
2079,579,622,891897,11829,1346274,936800
2080,557,630,891345,11751,1346904,958900
2081,607,617,890742,11737,1347521,1055100
2082,582,592,890160,11727,1348113,1050500
2083,626,586,889555,11746,1348699,1017600
2084,585,605,888955,11741,1349304,1051800
2085,586,670,888384,11642,1349974,1069700
2086,604,594,887762,11670,1350568,1183500
2087,595,631,887159,11642,1351199,1087300
2088,584,657,886585,11559,1351856,1064100
2089,599,630,885991,11523,1352486,994000
2090,569,529,885402,11583,1353015,1009200
2091,539,623,884883,11479,1353638,1033500
2092,607,617,884280,11465,1354255,1032700
2093,571,588,883691,11466,1354843,1017500
2094,588,577,883113,11467,1355420,973500
2095,581,600,882528,11452,1356020,973700
2096,590,594,881944,11442,1356614,984700
2097,586,581,881386,11419,1357195,957500
2098,560,618,880797,11390,1357813,998800
2099,589,575,880207,11405,1358388,1003200
2100,531,584,879654,11374,1358972,1009600
2101,551,560,879126,11342,1359532,1020700
2102,635,572,878499,11397,1360104,994900
2103,626,575,877860,11461,1360679,1076900
2104,589,575,877274,11472,1361254,1033500
2105,570,636,876734,11376,1361890,1022900
2106,580,638,876125,11347,1362528,975000
2107,577,631,875545,11296,1363159,981200
2108,556,549,874985,11307,1363708,986200
2109,582,562,874396,11334,1364270,961600
2110,515,576,873887,11267,1364846,963000
2111,589,575,873321,11258,1365421,984300
2112,552,544,872746,11289,1365965,937200
2113,574,606,872169,11260,1366571,959800
2114,572,600,871596,11233,1367171,963300
2115,609,608,871003,11218,1367779,969300
2116,583,603,870413,11205,1368382,967300
2117,578,617,869825,11176,1368999,1004100
2118,545,581,869288,11132,1369580,994800
2119,564,569,868719,11132,1370149,973100
2120,603,565,868116,11170,1370714,985000
2121,603,621,867535,11130,1371335,1014100
2122,613,562,866912,11191,1371897,961500
2123,621,604,866292,11207,1372501,964800
2124,583,572,865699,11228,1373073,951700
2125,588,581,865112,11234,1373654,943400
2126,570,608,864545,11193,1374262,971700
2127,565,574,863970,11194,1374836,979900
2128,585,588,863406,11170,1375424,942900
2129,512,616,862869,11091,1376040,963900
2130,519,562,862346,11052,1376602,982500
2131,557,584,861800,11014,1377186,980200
2132,566,568,861221,11025,1377754,1053500
2133,584,557,860668,11021,1378311,1051200
2134,570,544,860105,11040,1378855,1016900
2135,585,582,859506,11057,1379437,958600
2136,505,589,859002,10972,1380026,969700
2137,539,600,858455,10919,1380626,963300
2138,500,564,857961,10849,1381190,944100
2139,563,565,857398,10847,1381755,959000
2140,579,559,856806,10880,1382314,1001700
2141,583,567,856238,10881,1382881,980200
2142,600,548,855641,10930,1383429,989000
2143,584,533,855050,10988,1383962,1007400
2144,586,588,854462,10988,1384550,980300
2145,565,570,853896,10984,1385120,978800
2146,586,596,853314,10970,1385716,973500
2147,591,579,852718,10987,1386295,1132000
2148,572,585,852156,10964,1386880,1034600
2149,528,571,851621,10928,1387451,1049100
2150,513,565,851094,10890,1388016,1108600
2151,514,557,850592,10835,1388573,1113100
2152,566,580,850032,10815,1389153,1061200
2153,532,574,849496,10777,1389727,1021100
2154,599,517,848893,10863,1390244,1056500
2155,580,587,848328,10841,1390831,969500
2156,583,555,847742,10872,1391386,1115400
2157,566,520,847152,10942,1391906,1007900
2158,557,542,846620,10932,1392448,989900
2159,542,557,846067,10928,1393005,969900
2160,522,553,845527,10915,1393558,1039800
2161,584,528,844975,10939,1394086,1081500
2162,592,541,844383,10990,1394627,1052900
2163,562,567,843811,10995,1395194,997800
2164,608,598,843190,11018,1395792,947800
2165,582,596,842619,10993,1396388,965200
2166,533,560,842085,10967,1396948,973300
2167,545,573,841547,10932,1397521,942500
2168,539,557,841004,10918,1398078,933400
2169,573,557,840426,10939,1398635,1002800
2170,561,592,839856,10917,1399227,1072100
2171,547,557,839295,10921,1399784,1005700
2172,571,556,838746,10914,1400340,1009500
2173,565,535,838169,10956,1400875,973400
2174,559,584,837618,10923,1401459,961500
2175,570,595,837045,10901,1402054,940200
2176,559,555,836478,10913,1402609,963700
2177,569,546,835935,10910,1403155,952300
2178,588,570,835315,10960,1403725,1084400
2179,558,566,834770,10939,1404291,1069100
2180,573,599,834199,10911,1404890,1072200
2181,556,561,833670,10879,1405451,1050900
2182,512,563,833140,10846,1406014,1009400
2183,536,588,832594,10804,1406602,1014000
2184,584,594,832022,10782,1407196,1084500
2185,532,572,831475,10757,1407768,1045000
2186,513,572,830965,10695,1408340,1059700
2187,512,557,830463,10640,1408897,1048800
2188,557,541,829899,10663,1409438,1023800
2189,565,560,829356,10646,1409998,1026800
2190,514,560,828825,10617,1410558,1058700
2191,548,546,828272,10624,1411104,1054400
2192,543,549,827723,10624,1411653,998200
2193,534,565,827189,10593,1412218,1090200
2194,534,574,826654,10554,1412792,1056700
2195,503,558,826144,10506,1413350,1040800
2196,531,582,825622,10446,1413932,1013400
2197,564,567,825091,10410,1414499,1012800
2198,553,524,824514,10463,1415023,991600
2199,550,553,823966,10458,1415576,1023500
2200,553,508,823418,10498,1416084,1024000
2201,574,550,822841,10525,1416634,1035800
2202,536,525,822313,10528,1417159,1010500
2203,600,532,821700,10609,1417691,1019600
2204,560,596,821147,10566,1418287,994900
2205,561,540,820574,10599,1418827,991500
2206,591,543,819990,10640,1419370,1003400
2207,572,575,819428,10627,1419945,969000
2208,530,512,818878,10665,1420457,1076100
2209,575,551,818313,10679,1421008,1108600
2210,549,574,817769,10649,1421582,1066800
2211,605,562,817165,10691,1422144,1058400
2212,540,564,816610,10682,1422708,1071900
2213,551,486,816054,10752,1423194,1110000
2214,581,550,815494,10762,1423744,1029700
2215,581,537,814910,10809,1424281,1126600
2216,580,541,814308,10870,1424822,1142300
2217,539,555,813784,10839,1425377,1130600
2218,591,566,813200,10857,1425943,1237500
2219,586,578,812624,10855,1426521,1060100
2220,529,536,812098,10845,1427057,1170400
2221,552,533,811532,10878,1427590,1037000
2222,557,582,810975,10853,1428172,1032200
2223,533,546,810431,10851,1428718,1193600
2224,564,516,809858,10908,1429234,1059500
2225,554,600,809326,10840,1429834,1042500
2226,564,582,808758,10826,1430416,1044700
2227,516,553,808230,10801,1430969,1034900
2228,542,592,807675,10764,1431561,1010200
2229,563,540,807138,10761,1432101,1012200
2230,575,550,806575,10774,1432651,1029400
2231,580,568,805984,10797,1433219,1000500
2232,514,539,805439,10803,1433758,1029400
2233,554,566,804913,10763,1434324,1018400
2234,538,535,804373,10768,1434859,1038400
2235,508,537,803850,10754,1435396,1000400
2236,505,513,803340,10751,1435909,982800
2237,561,565,802804,10722,1436474,1036400
2238,567,534,802240,10752,1437008,1005000
2239,493,544,801714,10734,1437552,1017300
2240,514,567,801217,10664,1438119,977300
2241,542,521,800688,10672,1438640,1028400
2242,532,556,800140,10664,1439196,977400
2243,552,541,799603,10660,1439737,979300
2244,494,514,799083,10666,1440251,952900
2245,553,524,798548,10677,1440775,953100
2246,592,558,797984,10683,1441333,983100
2247,531,550,797435,10682,1441883,1005200
2248,575,574,796864,10679,1442457,995500
2249,533,569,796329,10645,1443026,989200
2250,531,556,795791,10627,1443582,950800
2251,548,549,795225,10644,1444131,988800
2252,515,529,794718,10622,1444660,936500
2253,517,520,794192,10628,1445180,1035800
2254,511,616,793687,10517,1445796,961900
2255,476,513,793194,10497,1446309,978300
2256,481,523,792717,10451,1446832,987400
2257,484,559,792248,10361,1447391,1001700
2258,531,492,791714,10403,1447883,954400
2259,503,519,791198,10400,1448402,989000
2260,567,533,790661,10404,1448935,973300
2261,523,533,790147,10385,1449468,971300
2262,528,540,789595,10397,1450008,980000
2263,510,539,789102,10351,1450547,978600
2264,472,544,788606,10303,1451091,916800
2265,498,541,788107,10261,1451632,988500
2266,516,513,787606,10249,1452145,987100
2267,496,574,787091,10190,1452719,1022900
2268,503,515,786599,10167,1453234,967400
2269,516,507,786088,10171,1453741,1015900
2270,475,527,785611,10121,1454268,1043300
2271,526,547,785083,10102,1454815,1041400
2272,541,524,784563,10098,1455339,1004900
2273,532,502,784002,10157,1455841,990500
2274,534,475,783486,10198,1456316,947300
2275,506,508,782975,10201,1456824,965500
2276,495,527,782463,10186,1457351,945800
2277,506,500,781974,10175,1457851,960500
2278,536,557,781448,10144,1458408,1098700
2279,525,552,780911,10129,1458960,1008900
2280,529,539,780367,10134,1459499,996200
2281,503,508,779865,10128,1460007,974100
2282,482,523,779405,10065,1460530,1030400
2283,503,500,778889,10081,1461030,1011700
2284,552,546,778364,10060,1461576,1067900
2285,536,557,777813,10054,1462133,1104100
2286,516,552,777280,10035,1462685,1019000
2287,541,522,776744,10049,1463207,1039500
2288,534,527,776222,10044,1463734,1005600
2289,520,528,775692,10046,1464262,1060400
2290,554,534,775152,10052,1464796,994300
2291,519,497,774644,10063,1465293,1009300
2292,513,535,774108,10064,1465828,971300
2293,524,475,773591,10106,1466303,996400
2294,498,490,773085,10122,1466793,949800
2295,537,536,772546,10125,1467329,950700
2296,528,531,772028,10112,1467860,971100
2297,492,487,771532,10121,1468347,1028800
2298,555,481,770975,10197,1468828,964800
2299,538,520,770445,10207,1469348,1178000
2300,506,537,769915,10200,1469885,993900
2301,532,506,769394,10215,1470391,974100
2302,513,514,768888,10207,1470905,974700
2303,540,508,768354,10233,1471413,972700
2304,544,551,767807,10229,1471964,1001700
2305,552,552,767233,10251,1472516,938400
2306,558,533,766694,10257,1473049,942300
2307,521,508,766185,10258,1473557,1036300
2308,564,542,765618,10283,1474099,946600
2309,530,549,765084,10268,1474648,957800
2310,540,569,764538,10245,1475217,977100
2311,504,581,764032,10170,1475798,979000
2312,545,499,763503,10200,1476297,980600
2313,512,513,762956,10234,1476810,948700
2314,518,545,762460,10185,1477355,949800
2315,504,512,761964,10169,1477867,942600
2316,517,564,761448,10121,1478431,1013300
2317,500,521,760933,10115,1478952,1004800
2318,514,510,760414,10124,1479462,988000
2319,549,509,759880,10149,1479971,953900
2320,468,522,759395,10112,1480493,970300
2321,506,495,758893,10119,1480988,965600
2322,480,523,758403,10086,1481511,962300
2323,490,541,757930,10018,1482052,967100
2324,491,510,757444,9994,1482562,959500
2325,504,547,756925,9966,1483109,987600
2326,530,525,756412,9954,1483634,1005200
2327,493,543,755911,9912,1484177,972900
2328,495,520,755407,9896,1484697,958700
2329,477,511,754934,9858,1485208,938000
2330,507,519,754422,9851,1485727,951900
2331,519,483,753917,9873,1486210,983800
2332,537,519,753393,9878,1486729,993600
2333,499,510,752875,9886,1487239,1087100
2334,496,478,752396,9887,1487717,999700
2335,524,492,751868,9923,1488209,989500
2336,572,507,751295,9989,1488716,968000
2337,524,506,750774,10004,1489222,1028900
2338,599,536,750188,10054,1489758,967200
2339,557,549,749615,10078,1490307,969700
2340,533,537,749064,10092,1490844,973900
2341,507,522,748562,10072,1491366,995700
2342,546,524,748046,10064,1491890,967900
2343,483,508,747544,10058,1492398,970700
2344,481,501,747051,10050,1492899,1009000
2345,477,543,746572,9986,1493442,1096000
2346,532,512,746064,9982,1493954,1055400
2347,489,483,745558,10005,1494437,1053600
2348,541,482,745028,10053,1494919,1019500
2349,558,550,744453,10078,1495469,1017100
2350,555,450,743913,10168,1495919,1041400
2351,557,533,743357,10191,1496452,1115600
2352,535,557,742812,10179,1497009,1125300
2353,537,492,742298,10201,1497501,1089300
2354,541,524,741746,10229,1498025,986900
2355,528,514,741214,10247,1498539,1017900
2356,552,536,740663,10262,1499075,1050000
2357,529,532,740132,10261,1499607,979900
2358,499,557,739611,10225,1500164,974200
2359,502,539,739117,10180,1500703,977400
2360,530,500,738599,10198,1501203,1000600
2361,517,509,738070,10218,1501712,983400
2362,528,528,737541,10219,1502240,1029700
2363,534,559,737024,10177,1502799,1095400
2364,506,529,736501,10171,1503328,986000
2365,516,583,736001,10088,1503911,960200
2366,539,516,735458,10115,1504427,995100
2367,507,566,734947,10060,1504993,995600
2368,517,528,734430,10049,1505521,961300
2369,516,507,733927,10045,1506028,994100
2370,532,558,733382,10032,1506586,987100
2371,497,544,732910,9960,1507130,1019000
2372,522,492,732366,10012,1507622,946800
2373,526,503,731833,10042,1508125,965800
2374,495,503,731342,10030,1508628,956400
2375,531,556,730809,10007,1509184,963300
2376,535,554,730277,9985,1509738,997300
2377,498,518,729766,9978,1510256,984000
2378,488,494,729292,9958,1510750,970200
2379,486,536,728790,9924,1511286,1097800
2380,542,522,728279,9913,1511808,1029200
2381,500,481,727775,9936,1512289,986300
2382,522,515,727242,9954,1512804,996300
2383,526,512,726719,9965,1513316,970200
2384,476,536,726241,9907,1513852,975300
2385,502,474,725742,9932,1514326,977200
2386,512,525,725230,9919,1514851,1001000
2387,518,516,724694,9939,1515367,960800
2388,493,505,724213,9915,1515872,1016600
2389,545,491,723667,9970,1516363,992800
2390,514,521,723156,9960,1516884,931900
2391,582,507,722589,10020,1517391,944400
2392,586,579,722019,10011,1517970,969200
2393,515,523,721501,10006,1518493,958100
2394,573,511,720901,10095,1519004,1023800
2395,541,562,720363,10071,1519566,1040400
2396,537,509,719829,10096,1520075,1033300
2397,562,512,719267,10146,1520587,1031800
2398,537,499,718728,10186,1521086,988900
2399,559,559,718179,10176,1521645,981500
2400,477,517,717672,10166,1522162,982600
2401,529,500,717182,10156,1522662,958500
2402,512,509,716657,10172,1523171,967500
2403,543,536,716114,10179,1523707,968900
2404,509,493,715601,10199,1524200,951300
2405,560,496,715044,10260,1524696,977400
2406,496,506,714536,10262,1525202,1016300
2407,536,539,714000,10259,1525741,1032500
2408,599,500,713432,10327,1526241,990000
2409,501,546,712900,10313,1526787,1052400
2410,509,504,712396,10313,1527291,1038300
2411,536,523,711862,10324,1527814,1135400
2412,573,498,711293,10395,1528312,1066100
2413,520,540,710771,10377,1528852,1008400
2414,533,557,710226,10365,1529409,1008400
2415,546,565,709688,10338,1529974,1107400
2416,508,512,709177,10337,1530486,1154200
2417,508,548,708672,10294,1531034,1111400
2418,496,521,708161,10284,1531555,1235400
2419,486,509,707673,10263,1532064,1041000
2420,514,552,707169,10215,1532616,1072600
2421,488,532,706685,10167,1533148,1059300
2422,514,533,706158,10161,1533681,1004700
2423,497,512,705668,10139,1534193,1030300
2424,512,505,705160,10142,1534698,1007200
2425,496,472,704666,10164,1535170,1000800
2426,492,496,704165,10169,1535666,1013400
2427,448,526,703705,10103,1536192,957400
2428,492,521,703227,10060,1536713,969400
2429,478,507,702756,10024,1537220,995300
2430,502,515,702228,10037,1537735,974600
2431,467,471,701762,10032,1538206,1139100
2432,477,492,701314,9988,1538698,1016400
2433,485,526,700799,9977,1539224,963500
2434,493,509,700320,9947,1539733,952300
2435,473,522,699830,9915,1540255,983000
2436,502,514,699358,9873,1540769,995900
2437,497,534,698844,9853,1541303,1002700
2438,501,515,698370,9812,1541818,959100
2439,499,506,697874,9802,1542324,1037000
2440,480,514,697371,9791,1542838,1033800
2441,549,525,696821,9816,1543363,1000300
2442,482,502,696325,9810,1543865,986000
2443,483,516,695848,9771,1544381,1044100
2444,511,513,695350,9756,1544894,1004100
2445,482,499,694870,9737,1545393,1046100
2446,530,483,694351,9773,1545876,970300
2447,513,468,693843,9813,1546344,980600
2448,498,553,693347,9756,1546897,992800
2449,512,469,692814,9820,1547366,966300
2450,517,494,692300,9840,1547860,959800
2451,521,517,691777,9846,1548377,945200
2452,476,525,691307,9791,1548902,946300
2453,480,533,690825,9740,1549435,1003400
2454,511,480,690315,9770,1549915,1021400
2455,473,486,689832,9767,1550401,1038200
2456,477,495,689353,9751,1550896,1046900
2457,508,509,688848,9747,1551405,987700
2458,479,488,688360,9747,1551893,995600
2459,490,499,687873,9735,1552392,978300
2460,465,500,687424,9684,1552892,1025600
2461,465,522,686944,9642,1553414,987700
2462,520,483,686429,9674,1553897,987000
2463,450,518,685974,9611,1554415,961600
2464,522,477,685465,9643,1554892,957500
2465,477,504,684967,9637,1555396,1031500
2466,445,537,684535,9532,1555933,993800
2467,497,499,684045,9523,1556432,978800
2468,493,480,683544,9544,1556912,1027500
2469,505,512,683054,9522,1557424,1027900
2470,440,474,682588,9514,1557898,1058400
2471,490,513,682115,9474,1558411,1004000
2472,480,453,681642,9494,1558864,976100
2473,460,467,681176,9493,1559331,1025600
2474,475,500,680688,9481,1559831,1023100
2475,480,459,680216,9494,1560290,988600
2476,489,520,679721,9469,1560810,1030900
2477,475,507,679243,9440,1561317,1077000
2478,484,537,678760,9386,1561854,1046500
2479,435,497,678312,9337,1562351,1021500
2480,490,481,677844,9324,1562832,1085300
2481,490,481,677352,9335,1563313,1070500
2482,446,459,676911,9317,1563772,1079000
2483,469,519,676443,9266,1564291,1053600
2484,439,425,675989,9295,1564716,1048300
2485,480,515,675515,9254,1565231,1031100
2486,441,433,675065,9271,1565664,989600
2487,425,434,674640,9262,1566098,1010500
2488,449,475,674206,9221,1566573,1092200
2489,458,485,673747,9195,1567058,977700
2490,460,496,673289,9157,1567554,998300
2491,432,447,672838,9161,1568001,963000
2492,465,459,672376,9164,1568460,983000
2493,461,479,671920,9141,1568939,995300
2494,458,508,671463,9090,1569447,1008400
2495,447,447,671021,9085,1569894,970200
2496,434,462,670592,9052,1570356,963000
2497,447,505,670126,9013,1570861,1005700
2498,466,470,669684,8985,1571331,978200
2499,462,487,669189,8993,1571818,995000
2500,449,440,668763,8979,1572258,1018200
2501,457,448,668295,8999,1572706,1009700
2502,437,443,667868,8983,1573149,961700
2503,476,478,667395,8978,1573627,1005000
2504,440,462,666950,8961,1574089,993600
2505,447,496,666494,8921,1574585,967500
2506,431,435,666076,8904,1575020,974100
2507,488,467,665602,8911,1575487,1022000
2508,403,454,665177,8882,1575941,992300
2509,441,472,664750,8837,1576413,969000
2510,439,479,664297,8811,1576892,939900
2511,447,460,663833,8815,1577352,1001500
2512,425,424,663420,8804,1577776,944100
2513,442,430,662980,8814,1578206,964800
2514,428,498,662540,8756,1578704,1003800
2515,428,429,662124,8743,1579133,1080000
2516,418,433,661708,8726,1579566,1106400
2517,472,465,661221,8748,1580031,1014200
2518,437,465,660797,8707,1580496,999100
2519,410,450,660388,8666,1580946,964500
2520,449,427,659961,8666,1581373,977900
2521,404,440,659532,8655,1581813,980700
2522,502,474,659036,8677,1582287,950700
2523,467,473,658576,8664,1582760,930500
2524,403,462,658155,8623,1583222,1001800
2525,481,428,657691,8659,1583650,965200
2526,416,480,657257,8613,1584130,953600
2527,434,453,656827,8590,1584583,949300
2528,439,443,656396,8578,1585026,989500
2529,423,457,655969,8548,1585483,940500
2530,449,423,655544,8550,1585906,936500
2531,477,453,655057,8584,1586359,988000
2532,437,438,654606,8597,1586797,957800
2533,439,457,654173,8573,1587254,983500
2534,449,469,653737,8540,1587723,999700
2535,472,428,653260,8589,1588151,962500
2536,485,476,652768,8605,1588627,937500
2537,470,419,652295,8659,1589046,985300
2538,457,441,651832,8681,1589487,966100
2539,467,444,651376,8693,1589931,937000
2540,441,439,650941,8689,1590370,950500
2541,481,460,650440,8730,1590830,950500
2542,482,452,650000,8718,1591282,1017400
2543,439,461,649531,8726,1591743,957200
2544,417,434,649102,8721,1592177,1067800
2545,464,423,648657,8743,1592600,1084700
2546,435,463,648198,8739,1593063,981700
2547,452,439,647771,8727,1593502,1051000
2548,430,431,647313,8754,1593933,1132400
2549,428,473,646894,8700,1594406,1037400
2550,414,447,646494,8653,1594853,1240200
2551,475,470,646029,8648,1595323,1044000
2552,448,404,645572,8701,1595727,1010100
2553,470,474,645092,8707,1596201,1126300
2554,398,404,644693,8702,1596605,1039300
2555,419,448,644262,8685,1597053,972400
2556,442,450,643836,8661,1597503,1016400
2557,445,429,643388,8680,1597932,962600
2558,458,438,642929,8701,1598370,953500
2559,407,417,642525,8688,1598787,986400
2560,434,418,642097,8698,1599205,974100
2561,416,447,641669,8679,1599652,1004200
2562,440,458,641227,8663,1600110,1043700
2563,447,444,640781,8665,1600554,1206100
2564,410,469,640369,8608,1601023,1016600
2565,426,467,639955,8555,1601490,966600
2566,453,446,639490,8574,1601936,975700
2567,406,423,639090,8551,1602359,1020800
2568,416,441,638671,8529,1602800,964500
2569,443,430,638244,8526,1603230,991700
2570,438,439,637790,8541,1603669,1104800
2571,425,469,637370,8492,1604138,949200
2572,450,408,636938,8516,1604546,973000
2573,430,463,636501,8490,1605009,957600
2574,394,464,636096,8431,1605473,994500
2575,433,416,635670,8441,1605889,966100
2576,439,412,635222,8477,1606301,952700
2577,409,436,634817,8446,1606737,981900
2578,473,453,634345,8465,1607190,1060600
2579,414,452,633921,8437,1607642,1032300
2580,424,411,633504,8443,1608053,1002300
2581,419,422,633085,8440,1608475,959700
2582,480,412,632614,8499,1608887,936300
2583,450,445,632172,8496,1609332,998300
2584,463,459,631693,8516,1609791,971500
2585,450,460,631248,8501,1610251,982000
2586,465,445,630786,8518,1610696,948400
2587,427,480,630353,8471,1611176,983900
2588,487,451,629867,8506,1611627,999700
2589,444,455,629422,8496,1612082,945300
2590,433,439,628986,8493,1612521,990200
2591,454,461,628539,8479,1612982,977100
2592,430,442,628117,8459,1613424,959300
2593,447,451,627652,8473,1613875,983900
2594,441,432,627221,8472,1614307,1043800
2595,472,446,626753,8494,1614753,987700
2596,465,454,626297,8496,1615207,986700
2597,443,429,625833,8531,1615636,970500
2598,434,464,625404,8496,1616100,948200
2599,447,440,624962,8498,1616540,979100
2600,415,444,624535,8481,1616984,951300
2601,454,467,624088,8461,1617451,958900
2602,443,471,623648,8430,1617922,952400
2603,491,470,623163,8445,1618392,1006400
2604,408,435,622726,8447,1618827,997500
2605,442,434,622314,8425,1619261,967500
2606,415,468,621890,8381,1619729,939900
2607,442,436,621439,8396,1620165,953500
2608,409,423,621030,8382,1620588,964500
2609,449,455,620592,8365,1621043,984900
2610,425,429,620185,8343,1621472,1140000
2611,433,427,619725,8376,1621899,1054800
2612,460,420,619267,8414,1622319,1031700
2613,432,453,618825,8403,1622772,1000000
2614,428,401,618401,8426,1623173,1114100
2615,435,411,617967,8449,1623584,1066800
2616,467,470,617504,8442,1624054,1223500
2617,436,464,617088,8394,1624518,1021600
2618,462,375,616610,8497,1624893,962700
2619,437,444,616160,8503,1625337,1275000
2620,452,434,615732,8497,1625771,1014400
2621,430,429,615289,8511,1626200,942400
2622,462,444,614836,8520,1626644,995200
2623,450,465,614374,8517,1627109,1016100
2624,446,429,613931,8531,1627538,1005200
2625,434,461,613507,8494,1627999,981500
2626,452,427,613039,8535,1628426,992600
2627,382,430,612655,8489,1628856,980300
2628,439,452,612221,8471,1629308,957500
2629,414,434,611806,8452,1629742,1147900
2630,434,394,611374,8490,1630136,960700
2631,461,429,610921,8514,1630565,959300
2632,438,424,610468,8543,1630989,956900
2633,459,444,610027,8540,1631433,959700
2634,380,460,609637,8470,1631893,999800
2635,448,442,609183,8482,1632335,981900
2636,429,459,608769,8437,1632794,964500
2637,457,427,608304,8475,1633221,992500
2638,431,433,607885,8461,1633654,933800
2639,426,460,607452,8434,1634114,964400
2640,419,452,607012,8422,1634566,967100
2641,442,409,606611,8414,1634975,1023700
2642,402,461,606197,8367,1635436,967200
2643,399,431,605766,8367,1635867,1008900
2644,434,428,605336,8369,1636295,988200
2645,421,378,604916,8411,1636673,1001700
2646,463,445,604473,8409,1637118,940800
2647,440,456,604016,8410,1637574,975700
2648,452,426,603577,8423,1638000,953500
2649,465,449,603118,8433,1638449,946700
2650,433,447,602673,8431,1638896,944300
2651,417,434,602268,8402,1639330,948900
2652,438,443,601809,8418,1639773,969900
2653,432,451,601384,8392,1640224,948500
2654,388,427,600991,8358,1640651,1025200
2655,393,446,600594,8309,1641097,975800
2656,428,408,600177,8318,1641505,923100
2657,396,415,599774,8306,1641920,968300
2658,431,429,599344,8307,1642349,973400
2659,486,388,598861,8402,1642737,963400
2660,454,417,598418,8428,1643154,940400
2661,364,471,598032,8343,1643625,936200
2662,413,412,597641,8322,1644037,958300
2663,385,429,597238,8296,1644466,1018500
2664,415,398,596825,8311,1644864,1007800
2665,450,422,596398,8316,1645286,964900
2666,421,425,595966,8323,1645711,971300
2667,432,436,595512,8341,1646147,949000
2668,397,432,595129,8292,1646579,965700
2669,410,444,594730,8247,1647023,988900
2670,378,464,594347,8166,1647487,935300
2671,391,427,593960,8126,1647914,986700
2672,401,430,593549,8107,1648344,952000
2673,399,410,593143,8103,1648754,1006800
2674,420,414,592750,8082,1649168,985800
2675,460,427,592281,8124,1649595,980000
2676,436,406,591845,8154,1650001,985600
2677,419,414,591424,8161,1650415,1102400
2678,408,415,591025,8145,1650830,1064900
2679,415,419,590589,8162,1651249,1018400
2680,412,423,590182,8146,1651672,1052900
2681,397,419,589781,8128,1652091,1069200
2682,458,427,589340,8142,1652518,1019500
2683,404,404,588905,8173,1652922,1052800
2684,414,434,588524,8120,1653356,1023000
2685,419,437,588079,8128,1653793,1030600
2686,430,419,587656,8132,1654212,1095100
2687,456,421,587205,8162,1654633,1011000
2688,396,443,586805,8119,1655076,1036600
2689,414,417,586384,8123,1655493,1108500
2690,395,389,585995,8123,1655882,1087700
2691,391,402,585591,8125,1656284,1049800
2692,452,427,585171,8118,1656711,975000
2693,413,397,584746,8146,1657108,1009000
2694,430,436,584312,8144,1657544,964100
2695,408,428,583908,8120,1657972,965100
2696,431,399,583475,8154,1658371,1019200
2697,411,445,583064,8120,1658816,1041400
2698,406,415,582654,8115,1659231,947900
2699,387,443,582246,8080,1659674,989500
2700,405,419,581861,8046,1660093,974300
2701,431,414,581447,8046,1660507,931500
2702,407,433,581017,8043,1660940,919200
2703,395,387,580629,8044,1661327,985500
2704,453,453,580189,8031,1661780,1130600
2705,427,449,579754,8017,1662229,1001200
2706,413,425,579339,8007,1662654,970000
2707,452,389,578905,8052,1663043,980400
2708,396,416,578490,8051,1663459,963400
2709,422,400,578069,8072,1663859,980000
2710,426,464,577646,8031,1664323,994100
2711,409,424,577229,8024,1664747,1051500
2712,439,432,576809,8012,1665179,973100
2713,390,434,576404,7983,1665613,1015000
2714,453,434,575961,7992,1666047,990600
2715,416,413,575544,7996,1666460,1012000
2716,375,403,575161,7976,1666863,986700
2717,423,383,574735,8019,1667246,940100
2718,417,406,574316,8032,1667652,957300
2719,434,415,573894,8039,1668067,1070600
2720,410,432,573469,8032,1668499,1035300
2721,378,456,573092,7953,1668955,1029500
2722,377,429,572706,7910,1669384,1069000
2723,390,402,572337,7877,1669786,1073400
2724,381,431,571956,7827,1670217,966000
2725,366,416,571566,7801,1670633,992700
2726,372,370,571201,7796,1671003,983800
2727,374,388,570821,7788,1671391,991600
2728,384,424,570455,7730,1671815,925400
2729,396,403,570058,7724,1672218,953200
2730,402,412,569635,7735,1672630,968300
2731,372,410,569274,7686,1673040,984300
2732,400,402,568892,7666,1673442,972000
2733,364,396,568521,7641,1673838,1001500
2734,381,392,568146,7624,1674230,959900
2735,416,374,567739,7657,1674604,1016200
2736,404,378,567320,7698,1674982,1032300
2737,414,398,566892,7728,1675380,1000300
2738,375,390,566524,7706,1675770,962800
2739,370,434,566145,7651,1676204,1047900
2740,392,411,565770,7615,1676615,989500
2741,374,409,565390,7586,1677024,1009400
2742,410,416,564981,7579,1677440,1088900
2743,433,400,564561,7599,1677840,1034300
2744,392,375,564146,7639,1678215,1007400
2745,401,400,563763,7622,1678615,1016000
2746,377,404,563363,7618,1679019,1042700
2747,363,411,563005,7565,1679430,1068000
2748,385,387,562629,7554,1679817,1055600
2749,365,392,562256,7535,1680209,1028200
2750,357,392,561891,7508,1680601,1043100
2751,412,389,561507,7503,1680990,1017800
2752,381,377,561113,7520,1681367,1082600
2753,388,398,560730,7505,1681765,1072900
2754,417,360,560317,7558,1682125,1014400
2755,355,353,559945,7577,1682478,985900
2756,381,387,559565,7570,1682865,962100
2757,378,410,559194,7531,1683275,968300
2758,355,423,558821,7481,1683698,963100
2759,422,387,558436,7479,1684085,971900
2760,341,429,558056,7430,1684514,936300
2761,363,404,557701,7381,1684918,990500
2762,351,349,557351,7382,1685267,1041900
2763,380,382,556982,7369,1685649,1084900
2764,379,362,556607,7382,1686011,1021800
2765,376,364,556236,7389,1686375,1020200
2766,392,393,555849,7383,1686768,1051600
2767,392,338,555439,7455,1687106,1028700
2768,372,425,555064,7405,1687531,1025700
2769,417,387,554660,7422,1687918,989300
2770,397,373,554249,7460,1688291,1036000
2771,398,402,553856,7451,1688693,1040800
2772,398,404,553466,7437,1689097,1053400
2773,393,397,553060,7446,1689494,1041100
2774,420,348,552669,7489,1689842,1696600
2775,429,364,552228,7566,1690206,1074400
2776,430,383,551799,7612,1690589,1110900
2777,431,334,551360,7717,1690923,1035300
2778,416,384,550940,7753,1691307,998600
2779,448,408,550514,7771,1691715,1017700
2780,382,433,550109,7743,1692148,1120700
2781,397,400,549715,7737,1692548,1058900
2782,399,411,549325,7716,1692959,1075200
2783,430,438,548867,7736,1693397,964000
2784,434,413,548477,7713,1693810,1026200
2785,421,387,548039,7764,1694197,1018600
2786,424,421,547595,7787,1694618,1011400
2787,387,422,547209,7751,1695040,995600
2788,403,454,546815,7691,1695494,1015000
2789,354,381,546444,7681,1695875,1082300
2790,413,390,546048,7687,1696265,1062400
2791,461,418,545606,7711,1696683,1036300
2792,403,393,545196,7728,1697076,1070500
2793,419,398,544778,7748,1697474,1016800
2794,406,385,544363,7778,1697859,1047500
2795,392,423,543965,7753,1698282,1054400
2796,416,385,543556,7777,1698667,1001000
2797,397,366,543157,7810,1699033,1019400
2798,384,378,542759,7830,1699411,984500
2799,418,370,542360,7859,1699781,994400
2800,419,440,541935,7844,1700221,1073900
2801,409,402,541515,7862,1700623,1055200
2802,392,406,541128,7843,1701029,1028000
2803,416,429,540743,7799,1701458,1075900
2804,425,395,540285,7862,1701853,1106500
2805,402,417,539895,7835,1702270,1043900
2806,363,393,539534,7803,1702663,1029400
2807,408,417,539116,7804,1703080,1049700
2808,407,417,538712,7791,1703497,1077800
2809,393,409,538318,7776,1703906,1150600
2810,381,411,537934,7749,1704317,1139500
2811,395,403,537527,7753,1704720,1110800
2812,390,389,537172,7719,1705109,1058900
2813,437,382,536731,7778,1705491,1047500
2814,425,380,536294,7835,1705871,1087600
2815,396,427,535888,7814,1706298,1035100
2816,416,393,535479,7830,1706691,1024900
2817,437,412,535047,7850,1707103,1015900
2818,363,426,534677,7794,1707529,1060200
2819,410,385,534278,7808,1707914,1077900
2820,412,366,533868,7852,1708280,1008200
2821,432,405,533429,7886,1708685,977800
2822,394,459,533046,7810,1709144,982200
2823,451,430,532603,7823,1709574,981800
2824,440,393,532141,7892,1709967,1038200
2825,415,392,531733,7908,1710359,1052600
2826,408,382,531330,7929,1710741,1033600
2827,426,381,530897,7981,1711122,1065100
2828,420,419,530490,7969,1711541,1028000
2829,443,387,530020,8052,1711928,986700
2830,399,393,529626,8053,1712321,986600
2831,404,437,529235,8007,1712758,1024700
2832,358,396,528871,7975,1713154,1015700
2833,406,390,528469,7987,1713544,973300
2834,412,433,528050,7973,1713977,987700
2835,444,397,527617,8009,1714374,981200
2836,398,425,527220,7981,1714799,995700
2837,385,409,526816,7976,1715208,997400
2838,387,430,526435,7927,1715638,1053600
2839,414,397,526046,7919,1716035,1029300
2840,433,421,525587,7957,1716456,1076500
2841,411,398,525189,7957,1716854,990600
2842,386,396,524794,7956,1717250,1059600
2843,420,397,524387,7966,1717647,1000800
2844,413,421,523961,7971,1718068,997600
2845,383,407,523578,7947,1718475,978800
2846,356,441,523217,7867,1718916,981700
2847,394,410,522823,7851,1719326,1020000
2848,386,390,522438,7846,1719716,1071100
2849,351,424,522093,7767,1720140,1049400
2850,369,397,521717,7746,1720537,1014400
2851,392,392,521316,7755,1720929,975800
2852,408,426,520921,7724,1721355,967300
2853,422,428,520499,7718,1721783,1007100
2854,384,403,520112,7702,1722186,1060400
2855,413,413,519689,7712,1722599,1015800
2856,371,389,519330,7682,1722988,984400
2857,371,406,518953,7653,1723394,989700
2858,354,390,518612,7604,1723784,1034600
2859,389,395,518215,7606,1724179,1018000
2860,371,402,517831,7588,1724581,1037000
2861,375,381,517462,7576,1724962,1074600
2862,366,366,517104,7568,1725328,1013200
2863,407,390,516695,7587,1725718,1021300
2864,409,387,516306,7589,1726105,1055900
2865,400,402,515894,7599,1726507,1045100
2866,381,406,515504,7583,1726913,1030700
2867,366,405,515140,7542,1727318,1040100
2868,370,384,514767,7531,1727702,1027600
2869,386,395,514392,7511,1728097,1071500
2870,366,389,514011,7503,1728486,1202500
2871,378,413,513642,7459,1728899,1039100
2872,335,389,513295,7417,1729288,1051300
2873,353,358,512950,7404,1729646,1075700
2874,375,387,512575,7392,1730033,1085400
2875,366,376,512197,7394,1730409,1105200
2876,391,375,511819,7397,1730784,1056500
2877,376,390,511460,7366,1731174,1062300
2878,374,402,511068,7356,1731576,968600
2879,373,354,510679,7391,1731930,1012500
2880,395,383,510310,7377,1732313,986200
2881,384,374,509909,7404,1732687,973300
2882,385,339,509521,7453,1733026,940900
2883,353,371,509167,7436,1733397,936800
2884,370,411,508809,7383,1733808,954100
2885,338,405,508475,7312,1734213,1070100
2886,383,411,508087,7289,1734624,1215500
2887,350,406,507726,7244,1735030,1096500
2888,372,346,507367,7257,1735376,1119700
2889,345,346,507027,7251,1735722,1059500
2890,349,335,506660,7283,1736057,1029700
2891,368,408,506296,7239,1736465,1040700
2892,371,346,505933,7256,1736811,1030400
2893,358,359,505582,7248,1737170,1025700
2894,404,376,505174,7280,1737546,1001600
2895,427,369,504773,7312,1737915,998300
2896,414,364,504329,7392,1738279,1043900
2897,379,406,503946,7369,1738685,1016100
2898,398,365,503546,7404,1739050,1075300
2899,366,386,503195,7369,1739436,1242100
2900,404,349,502775,7440,1739785,1060800
2901,411,363,502386,7466,1740148,1017000
2902,379,403,501981,7468,1740551,1034700
2903,376,391,501620,7438,1740942,1026000
2904,370,399,501252,7407,1741341,1039600
2905,353,411,500884,7364,1741752,1060700
2906,370,408,500533,7307,1742160,1079700
2907,379,383,500144,7313,1742543,1064900
2908,395,374,499752,7331,1742917,1083300
2909,372,372,499376,7335,1743289,1083900
2910,359,383,499014,7314,1743672,1049100
2911,390,371,498620,7337,1744043,1035800
2912,342,373,498278,7306,1744416,1102300
2913,392,397,497904,7283,1744813,1060300
2914,420,402,497465,7320,1745215,1073400
2915,335,358,497137,7290,1745573,1086800
2916,400,374,496739,7314,1745947,1101500
2917,352,342,496382,7329,1746289,1058100
2918,419,397,495971,7343,1746686,1052800
2919,377,374,495604,7336,1747060,1119700
2920,333,357,495239,7344,1747417,1101000
2921,392,367,494862,7354,1747784,1196200
2922,393,408,494476,7332,1748192,1423200
2923,353,428,494104,7276,1748620,1281500
2924,381,378,493742,7260,1748998,1198300
2925,378,364,493353,7285,1749362,1252500
2926,374,373,492991,7274,1749735,1148000
2927,389,415,492603,7247,1750150,1233900
2928,347,334,492246,7270,1750484,1207100
2929,385,406,491859,7251,1750890,1250600
2930,340,404,491518,7188,1751294,1209800
2931,370,373,491162,7171,1751667,1316900
2932,346,379,490820,7134,1752046,1182300
2933,342,373,490459,7122,1752419,1038400
2934,353,358,490104,7119,1752777,1025400
2935,347,373,489752,7098,1753150,1034500
2936,344,342,489416,7092,1753492,1051300
2937,380,368,489056,7084,1753860,1050500
2938,345,345,488693,7102,1754205,1030900
2939,368,356,488321,7118,1754561,1025900
2940,338,383,487980,7076,1754944,1081800
2941,362,379,487624,7053,1755323,1120200
2942,364,389,487258,7030,1755712,1081200
2943,353,384,486910,6994,1756096,1075400
2944,357,375,486550,6979,1756471,983500
2945,354,362,486193,6974,1756833,1049600
2946,372,365,485824,6978,1757198,1030500
2947,365,377,485459,6966,1757575,948600
2948,343,347,485116,6962,1757922,938000
2949,386,330,484733,7015,1758252,937300
2950,391,367,484360,7021,1758619,994400
2951,384,337,483959,7085,1758956,989200
2952,395,382,483557,7105,1759338,957900
2953,350,375,483215,7072,1759713,925700
2954,361,359,482849,7079,1760072,991400
2955,364,350,482489,7089,1760422,956600
2956,350,379,482121,7078,1760801,1155400
2957,365,396,481784,7019,1761197,1035200
2958,382,365,481397,7041,1761562,964900
2959,360,350,481025,7063,1761912,936400
2960,379,388,480661,7039,1762300,1035600
2961,352,352,480295,7053,1762652,978300
2962,362,362,479944,7042,1763014,964900
2963,373,402,479552,7032,1763416,934600
2964,374,375,479187,7022,1763791,928800
2965,364,408,478830,6971,1764199,934600
2966,392,358,478440,7003,1764557,930600
2967,374,378,478074,6991,1764935,933900
2968,357,353,477711,7001,1765288,937400
2969,370,365,477335,7012,1765653,958000
2970,373,365,476960,7022,1766018,935100
2971,368,306,476610,7066,1766324,977200
2972,407,409,476191,7076,1766733,945800
2973,426,369,475753,7145,1767102,998900
2974,415,362,475351,7185,1767464,992400
2975,380,384,474957,7195,1767848,1012000
2976,394,352,474560,7240,1768200,955200
2977,382,373,474195,7232,1768573,955100
2978,359,376,473829,7222,1768949,967600
2979,374,392,473449,7210,1769341,957500
2980,394,379,473087,7193,1769720,970400
2981,389,375,472679,7226,1770095,1012700
2982,384,387,472282,7236,1770482,1014200
2983,385,415,471904,7199,1770897,1059500
2984,363,389,471541,7173,1771286,914700
2985,365,368,471175,7171,1771654,970400
2986,382,368,470799,7179,1772022,918600
2987,332,376,470460,7142,1772398,953200
2988,334,357,470131,7114,1772755,962900
2989,404,379,469729,7137,1773134,1004100
2990,380,356,469349,7161,1773490,944900
2991,385,383,468959,7168,1773873,1169700
2992,358,404,468586,7137,1774277,981500
2993,341,351,468252,7120,1774628,944500
2994,363,371,467906,7095,1774999,975800
2995,385,330,467511,7160,1775329,1084200
2996,391,387,467139,7145,1775716,978500
2997,365,382,466765,7137,1776098,947500
2998,347,383,466398,7121,1776481,971500
2999,346,396,466049,7074,1776877,1009900
3000,399,349,465681,7093,1777226,1131100
3001,379,368,465303,7103,1777594,1095000
3002,390,371,464915,7120,1777965,1049000
3003,352,401,464534,7100,1778366,1057800
3004,384,370,464166,7098,1778736,1063300
3005,364,348,463799,7117,1779084,1006100
3006,385,394,463415,7107,1779478,1038400
3007,367,329,463044,7149,1779807,1000700
3008,401,371,462649,7173,1780178,964200
3009,376,380,462255,7187,1780558,1018200
3010,392,380,461882,7180,1780938,958100
3011,367,359,461500,7203,1781297,1021900
3012,347,337,461148,7218,1781634,999200
3013,373,386,460770,7210,1782020,966800
3014,357,382,460434,7164,1782402,962800
3015,366,374,460072,7152,1782776,997200
3016,394,361,459673,7190,1783137,965600
3017,380,362,459305,7196,1783499,1019500
3018,370,372,458911,7218,1783871,959500
3019,375,353,458541,7235,1784224,1016700
3020,370,398,458182,7196,1784622,961300
3021,378,351,457797,7230,1784973,994500
3022,376,363,457426,7238,1785336,960200
3023,389,380,457037,7247,1785716,962900
3024,390,377,456646,7261,1786093,943200
3025,368,407,456280,7220,1786500,930500
3026,347,392,455923,7185,1786892,924400
3027,357,374,455561,7173,1787266,920700
3028,361,349,455213,7172,1787615,929000
3029,343,393,454854,7138,1788008,935700
3030,365,394,454499,7099,1788402,948700
3031,329,389,454170,7039,1788791,965500
3032,381,381,453795,7033,1789172,970000
3033,389,364,453396,7068,1789536,952400
3034,346,371,453058,7035,1789907,934900
3035,378,379,452670,7044,1790286,963600
3036,362,358,452312,7044,1790644,1008800
3037,358,334,451961,7061,1790978,964700
3038,384,346,451573,7103,1791324,929600
3039,403,366,451171,7139,1791690,916500
3040,363,370,450803,7137,1792060,923300
3041,363,374,450445,7121,1792434,953000
3042,367,363,450072,7131,1792797,971900
3043,403,366,449678,7159,1793163,954000
3044,344,379,449331,7127,1793542,919700
3045,390,374,448935,7149,1793916,942900
3046,377,392,448569,7123,1794308,917100
3047,403,389,448168,7135,1794697,928300
3048,380,361,447780,7162,1795058,936500
3049,354,370,447427,7145,1795428,950200
3050,362,396,447059,7117,1795824,970700
3051,363,339,446712,7125,1796163,932300
3052,391,365,446305,7167,1796528,1044600
3053,375,350,445932,7190,1796878,958000
3054,362,378,445566,7178,1797256,955900
3055,379,395,445196,7153,1797651,930200
3056,350,380,444846,7123,1798031,940500
3057,377,375,444453,7141,1798406,970900
3058,373,370,444099,7125,1798776,980000
3059,366,401,443726,7097,1799177,935000
3060,346,393,443375,7055,1799570,972400
3061,374,363,443015,7052,1799933,936500
3062,338,365,442659,7043,1800298,965600
3063,375,363,442298,7041,1800661,980400
3064,410,344,441902,7093,1801005,963900
3065,366,367,441512,7116,1801372,1055600
3066,334,365,441170,7093,1801737,992400
3067,373,356,440810,7097,1802093,965100
3068,345,404,440476,7027,1802497,1036400
3069,348,378,440118,7007,1802875,1150000
3070,331,385,439782,6958,1803260,1038200
3071,305,369,439482,6889,1803629,1074200
3072,335,348,439142,6881,1803977,1110400
3073,355,339,438789,6895,1804316,994900
3074,327,355,438470,6859,1804671,977900
3075,363,332,438112,6885,1805003,1017300
3076,348,342,437758,6897,1805345,997500
3077,324,342,437418,6895,1805687,973700
3078,328,365,437096,6852,1806052,958800
3079,358,355,436751,6842,1806407,931100
3080,348,352,436389,6852,1806759,942200
3081,335,321,436044,6876,1807080,896800
3082,376,357,435695,6868,1807437,957400
3083,376,324,435309,6930,1807761,940300
3084,378,371,434937,6931,1808132,1007900
3085,333,350,434594,6924,1808482,1085500
3086,361,356,434235,6927,1808838,973100
3087,349,357,433882,6923,1809195,948600
3088,355,360,433525,6920,1809555,985200
3089,327,350,433209,6886,1809905,930000
3090,335,351,432857,6887,1810256,921400
3091,367,354,432501,6889,1810610,925400
3092,364,377,432142,6871,1810987,929800
3093,340,347,431786,6880,1811334,992400
3094,358,355,431445,6866,1811689,936700
3095,327,352,431094,6865,1812041,938700
3096,348,352,430767,6840,1812393,925600
3097,366,355,430400,6852,1812748,968800
3098,375,323,430028,6901,1813071,923700
3099,349,356,429680,6893,1813427,980400
3100,361,377,429330,6866,1813804,919300
3101,341,377,428970,6849,1814181,931400
3102,387,377,428594,6848,1814558,947700
3103,355,331,428228,6883,1814889,950100
3104,361,368,427876,6867,1815257,971100
3105,314,357,427543,6843,1815614,930200
3106,351,354,427220,6812,1815968,930800
3107,312,336,426889,6807,1816304,942800
3108,369,363,426509,6824,1816667,930200
3109,366,339,426156,6838,1817006,913200
3110,384,339,425773,6882,1817345,931100
3111,375,373,425415,6867,1817718,946200
3112,350,329,425045,6908,1818047,903000
3113,392,365,424668,6920,1818412,960700
3114,355,349,424302,6937,1818761,984100
3115,360,358,423946,6935,1819119,948800
3116,372,381,423578,6922,1819500,1023300
3117,369,346,423202,6952,1819846,988600
3118,370,325,422841,6988,1820171,937700
3119,378,358,422468,7003,1820529,929200
3120,390,375,422070,7026,1820904,936500
3121,336,375,421730,6991,1821279,921700
3122,347,365,421379,6977,1821644,952100
3123,359,371,421011,6974,1822015,957400
3124,398,395,420628,6962,1822410,967000
3125,389,325,420227,7038,1822735,946800
3126,371,401,419862,7002,1823136,932500
3127,335,371,419525,6968,1823507,939900
3128,357,340,419166,6987,1823847,937400
3129,392,356,418776,7021,1824203,943100
3130,353,354,418434,7009,1824557,927600
3131,373,394,418068,6981,1824951,942900
3132,341,355,417696,6998,1825306,1001800
3133,314,357,417383,6954,1825663,1070300
3134,378,362,417028,6947,1826025,1027000
3135,356,334,416662,6979,1826359,965200
3136,370,356,416303,6982,1826715,954600
3137,344,364,415935,6986,1827079,997900
3138,365,368,415604,6949,1827447,1037500
3139,368,353,415236,6964,1827800,1008200
3140,386,350,414847,7003,1828150,1080700
3141,350,363,414481,7006,1828513,1010100
3142,359,357,414132,6998,1828870,961100
3143,366,348,413751,7031,1829218,964500
3144,322,372,413421,6989,1829590,1079800
3145,340,364,413102,6944,1829954,974100
3146,345,376,412762,6908,1830330,958600
3147,348,362,412401,6907,1830692,918800
3148,354,378,412051,6879,1831070,1011500
3149,355,350,411675,6905,1831420,1002900
3150,345,351,411338,6891,1831771,952300
3151,329,332,411013,6884,1832103,934300
3152,334,357,410681,6859,1832460,940000
3153,366,387,410319,6834,1832847,941900
3154,384,363,409930,6860,1833210,1004400
3155,309,370,409613,6807,1833580,971100
3156,352,361,409281,6778,1833941,937200
3157,345,351,408929,6779,1834292,948300
3158,341,339,408582,6787,1834631,942900
3159,340,353,408242,6774,1834984,932100
3160,315,355,407914,6747,1835339,946700
3161,348,360,407570,6731,1835699,920100
3162,341,364,407243,6694,1836063,924000
3163,356,379,406880,6678,1836442,937500
3164,330,324,406560,6674,1836766,1051200
3165,333,353,406232,6649,1837119,1044900
3166,353,355,405861,6665,1837474,1029000
3167,348,331,405523,6672,1837805,996100
3168,342,348,405181,6666,1838153,986900
3169,319,333,404864,6650,1838486,992000
3170,348,317,404530,6667,1838803,990300
3171,345,344,404159,6694,1839147,997800
3172,323,359,403841,6653,1839506,1003700
3173,355,331,403498,6665,1839837,988800
3174,345,333,403157,6673,1840170,969100
3175,356,349,402785,6696,1840519,1071300
3176,367,356,402422,6703,1840875,1011500
3177,322,355,402098,6672,1841230,1001500
3178,346,374,401749,6647,1841604,984900
3179,321,325,401433,6638,1841929,1041700
3180,359,358,401070,6643,1842287,1017600
3181,382,348,400689,6676,1842635,1016400
3182,351,360,400343,6662,1842995,1003000
3183,310,344,400028,6633,1843339,1032500
3184,336,324,399701,6636,1843663,1036000
3185,365,357,399331,6649,1844020,1015700
3186,347,355,398979,6646,1844375,1013800
3187,331,319,398649,6657,1844694,1001800
3188,340,375,398316,6615,1845069,970600
3189,329,321,397990,6620,1845390,982100
3190,338,334,397645,6631,1845724,971500
3191,335,323,397314,6639,1846047,969400
3192,347,315,396972,6666,1846362,1012500
3193,351,354,396623,6661,1846716,1025400
3194,301,337,396313,6634,1847053,1025000
3195,373,324,395935,6688,1847377,1070900
3196,355,376,395590,6657,1847753,1026700
3197,362,352,395215,6680,1848105,1010800
3198,327,368,394886,6641,1848473,1000100
3199,284,338,394596,6593,1848811,1003300
3200,335,337,394275,6577,1849148,1003800
3201,324,331,393951,6570,1849479,1024500
3202,320,360,393625,6536,1849839,1093900
3203,372,341,393258,6562,1850180,1045400
3204,331,358,392932,6530,1850538,1128800
3205,317,310,392599,6553,1850848,1096000
3206,309,315,392289,6548,1851163,1098400
3207,341,314,391964,6559,1851477,1109500
3208,369,353,391605,6565,1851830,1018700
3209,339,329,391257,6584,1852159,1290400
3210,323,352,390925,6564,1852511,1088100
3211,357,309,390564,6616,1852820,1018500
3212,367,356,390202,6622,1853176,1002500
3213,351,348,389862,6614,1853524,1034600
3214,322,328,389526,6622,1853852,982000
3215,351,348,389183,6617,1854200,990100
3216,351,365,388825,6610,1854565,1007700
3217,383,333,388455,6647,1854898,972500
3218,354,357,388101,6644,1855255,947100
3219,389,354,387718,6673,1855609,1200900
3220,382,347,387314,6730,1855956,994500
3221,364,343,386965,6736,1856299,953200
3222,363,360,386611,6730,1856659,939300
3223,368,370,386231,6740,1857029,958700
3224,355,309,385876,6786,1857338,979900
3225,315,335,385570,6757,1857673,1007300
3226,346,366,385220,6741,1858039,991400
3227,347,344,384869,6748,1858383,949700
3228,310,345,384542,6730,1858728,950100
3229,290,327,384255,6690,1859055,932600
3230,373,371,383900,6674,1859426,921700
3231,316,326,383553,6695,1859752,967100
3232,358,312,383221,6715,1860064,930000
3233,318,353,382902,6681,1860417,978000
3234,340,341,382556,6686,1860758,976700
3235,343,339,382214,6689,1861097,944300
3236,336,345,381877,6681,1861442,946800
3237,342,343,381541,6674,1861785,949900
3238,312,342,381215,6658,1862127,923600
3239,316,332,380892,6649,1862459,929000
3240,344,342,380579,6620,1862801,934000
3241,344,286,380218,6695,1863087,954500
3242,351,330,379873,6710,1863417,977400
3243,323,362,379566,6655,1863779,943600
3244,372,341,379179,6701,1864120,1029100
3245,341,313,378839,6728,1864433,939800
3246,338,375,378495,6697,1864808,918800
3247,329,315,378171,6706,1865123,949500
3248,339,323,377830,6724,1865446,925000
3249,339,353,377497,6704,1865799,936700
3250,304,361,377183,6657,1866160,924600
3251,316,343,376868,6629,1866503,964100
3252,319,358,376554,6585,1866861,912800
3253,390,344,376174,6621,1867205,975500
3254,341,359,375824,6612,1867564,921900
3255,327,396,375496,6544,1867960,969000
3256,354,334,375140,6566,1868294,929800
3257,372,338,374767,6601,1868632,969600
3258,312,351,374449,6568,1868983,1062700
3259,346,323,374111,6583,1869306,1023200
3260,324,318,373798,6578,1869624,988900
3261,369,322,373426,6628,1869946,956300
3262,350,308,373069,6677,1870254,940400
3263,325,355,372745,6646,1870609,949200
3264,331,318,372412,6661,1870927,994200
3265,368,342,372047,6684,1871269,975500
3266,329,373,371708,6650,1871642,1073600
3267,316,342,371391,6625,1871984,982600
3268,302,310,371088,6618,1872294,964300
3269,304,327,370790,6589,1872621,1000500
3270,330,317,370467,6595,1872938,1003400
3271,308,335,370150,6577,1873273,1143000
3272,329,366,369822,6539,1873639,1045600
3273,344,322,369481,6558,1873961,1065500
3274,348,322,369137,6580,1874283,1074400
3275,343,332,368775,6610,1874615,978600
3276,304,345,368480,6560,1874960,1013100
3277,330,328,368159,6553,1875288,1003600
3278,313,342,367840,6530,1875630,945500
3279,334,310,367515,6545,1875940,951700
3280,326,351,367187,6522,1876291,929800
3281,320,364,366854,6491,1876655,899000
3282,329,327,366532,6486,1876982,924200
3283,326,306,366215,6497,1877288,955600
3284,340,341,365857,6514,1877629,953000
3285,324,326,365532,6513,1877955,938000
3286,347,328,365204,6513,1878283,935500
3287,325,332,364873,6512,1878615,961000
3288,331,349,364551,6485,1878964,968000
3289,345,308,364199,6529,1879272,1003700
3290,322,334,363876,6518,1879606,972900
3291,311,309,363581,6504,1879915,945100
3292,330,319,363231,6535,1880234,965200
3293,306,350,362917,6499,1880584,928600
3294,360,344,362570,6502,1880928,922900
3295,330,327,362236,6509,1881255,982800
3296,354,359,361886,6500,1881614,980500
3297,332,353,361536,6497,1881967,942800
3298,349,332,361201,6500,1882299,945900
3299,361,316,360839,6546,1882615,951200
3300,337,329,360508,6548,1882944,929000
3301,332,357,360163,6536,1883301,922300
3302,347,352,359834,6513,1883653,935700
3303,327,327,359495,6525,1883980,952400
3304,342,335,359164,6521,1884315,958700
3305,327,353,358827,6505,1884668,965000
3306,369,357,358477,6498,1885025,1022200
3307,318,323,358141,6511,1885348,977100
3308,328,357,357812,6483,1885705,931900
3309,344,320,357474,6501,1886025,926000
3310,352,370,357136,6469,1886395,930900
3311,341,328,356778,6499,1886723,923400
3312,321,333,356469,6475,1887056,920800
3313,338,375,356109,6460,1887431,936000
3314,351,350,355761,6458,1887781,901900
3315,354,324,355409,6486,1888105,940600
3316,344,322,355069,6504,1888427,965900
3317,367,320,354715,6538,1888747,943700
3318,344,330,354358,6565,1889077,925200
3319,360,336,353999,6588,1889413,919800
3320,329,310,353681,6596,1889723,937500
3321,368,355,353296,6626,1890078,941600
3322,326,358,352971,6593,1890436,1021500
3323,332,340,352655,6569,1890776,1044500
3324,335,376,352311,6537,1891152,958600
3325,352,296,351965,6587,1891448,963300
3326,374,336,351591,6625,1891784,981400
3327,320,322,351265,6629,1892106,956800
3328,358,336,350909,6649,1892442,916100
3329,378,352,350542,6664,1892794,915700
3330,353,330,350180,6696,1893124,940300
3331,380,364,349785,6727,1893488,928500
3332,352,368,349442,6702,1893856,922500
3333,345,334,349095,6715,1894190,961600
3334,379,384,348725,6701,1894574,963800
3335,340,360,348376,6690,1894934,943800
3336,334,358,348037,6671,1895292,979700
3337,331,335,347716,6657,1895627,1069000
3338,349,385,347360,6628,1896012,982600
3339,312,350,347055,6583,1896362,1035900
3340,317,351,346725,6562,1896713,1040800
3341,350,369,346378,6540,1897082,1061400
3342,317,338,346080,6500,1897420,1047800
3343,324,326,345743,6511,1897746,1126400
3344,342,333,345400,6521,1898079,965500
3345,376,340,345035,6546,1898419,962200
3346,354,320,344680,6581,1898739,1048400
3347,345,351,344323,6587,1899090,978700
3348,358,315,343974,6621,1899405,974800
3349,333,341,343637,6617,1899746,935100
3350,351,361,343292,6601,1900107,933500
3351,327,353,342958,6582,1900460,984700
3352,368,359,342591,6590,1900819,932400
3353,367,316,342225,6640,1901135,919000
3354,338,368,341893,6604,1901503,969700
3355,371,345,341512,6640,1901848,957700
3356,356,357,341163,6632,1902205,1174400
3357,343,345,340807,6643,1902550,989800
3358,361,334,340459,6657,1902884,971900
3359,335,346,340123,6647,1903230,928300
3360,353,324,339766,6680,1903554,919900
3361,306,347,339457,6642,1903901,912200
3362,311,330,339137,6632,1904231,909200
3363,358,355,338782,6632,1904586,972100
3364,342,338,338458,6618,1904924,929600
3365,314,320,338118,6638,1905244,965700
3366,333,350,337796,6610,1905594,942600
3367,332,323,337467,6616,1905917,987900
3368,285,328,337175,6580,1906245,1007200
3369,331,335,336844,6576,1906580,991000
3370,319,353,336535,6532,1906933,1032200
3371,334,335,336197,6535,1907268,985900
3372,340,343,335868,6521,1907611,975200
3373,345,346,335511,6532,1907957,940200
3374,313,343,335200,6500,1908300,941600
3375,266,342,334922,6436,1908642,955400
3376,353,349,334602,6407,1908991,928000
3377,350,330,334230,6449,1909321,971000
3378,330,340,333884,6455,1909661,979600
3379,317,305,333575,6459,1909966,1031800
3380,302,327,333278,6429,1910293,940900
3381,343,332,332941,6434,1910625,942600
3382,309,341,332620,6414,1910966,935100
3383,309,318,332321,6395,1911284,933400
3384,297,346,332017,6353,1911630,944800
3385,335,326,331683,6361,1911956,926000
3386,310,348,331382,6314,1912304,954300
3387,321,323,331050,6323,1912627,1030300
3388,309,303,330733,6337,1912930,1003100
3389,336,311,330414,6345,1913241,966100
3390,361,324,330066,6369,1913565,937400
3391,323,325,329714,6396,1913890,932000
3392,320,332,329408,6370,1914222,917500
3393,324,318,329076,6384,1914540,911700
3394,305,338,328771,6351,1914878,933500
3395,292,347,328483,6292,1915225,946300
3396,299,343,328194,6238,1915568,933300
3397,299,333,327892,6207,1915901,963900
3398,261,344,327613,6142,1916245,994100
3399,319,290,327307,6158,1916535,939700
3400,318,298,327003,6164,1916833,932200
3401,302,294,326686,6187,1917127,923700
3402,334,317,326363,6193,1917444,958700
3403,315,332,326038,6186,1917776,1030700
3404,267,318,325765,6141,1918094,982900
3405,297,311,325472,6123,1918405,1017000
3406,333,331,325146,6118,1918736,1023700
3407,326,337,324827,6100,1919073,943300
3408,334,323,324482,6122,1919396,1092700
3409,321,314,324169,6121,1919710,1032700
3410,289,312,323866,6112,1920022,1018000
3411,297,323,323569,6086,1920345,1045500
3412,290,313,323281,6061,1920658,983800
3413,312,282,322965,6095,1920940,946400
3414,319,299,322652,6109,1921239,970000
3415,321,349,322335,6077,1921588,955500
3416,300,323,322058,6031,1921911,993400
3417,290,305,321725,6059,1922216,928000
3418,280,287,321459,6038,1922503,997800
3419,303,318,321148,6031,1922821,971200
3420,314,318,320852,6009,1923139,970600
3421,319,290,320531,6040,1923429,942400
3422,319,317,320215,6039,1923746,965900
3423,317,311,319884,6059,1924057,936100
3424,309,310,319585,6048,1924367,933300
3425,305,303,319281,6049,1924670,952000
3426,285,329,318974,6027,1924999,926300
3427,283,303,318706,5992,1925302,956100
3428,300,316,318399,5983,1925618,937500
3429,286,306,318120,5956,1925924,945900
3430,304,310,317806,5960,1926234,941600
3431,316,283,317496,5987,1926517,942400
3432,332,299,317169,6015,1926816,946000
3433,318,301,316853,6030,1927117,947900
3434,289,295,316556,6032,1927412,956100
3435,305,313,316263,6012,1927725,972100
3436,291,331,315967,5977,1928056,958400
3437,288,300,315669,5975,1928356,903100
3438,304,295,315371,5978,1928651,916400
3439,310,329,315049,5971,1928980,993800
3440,291,279,314774,5967,1929259,952500
3441,336,332,314460,5949,1929591,945700
3442,256,311,314174,5924,1929902,955000
3443,305,308,313864,5926,1930210,969200
3444,291,274,313573,5943,1930484,942000
3445,311,277,313259,5980,1930761,944000
3446,298,324,312977,5938,1931085,978300
3447,303,316,312669,5930,1931401,916100
3448,315,289,312362,5948,1931690,925400
3449,311,299,312046,5965,1931989,990400
3450,312,357,311724,5930,1932346,943100
3451,269,312,311461,5881,1932658,1066000
3452,282,306,311171,5865,1932964,1015200
3453,287,298,310886,5852,1933262,973500
3454,264,324,310629,5785,1933586,946100
3455,251,314,310374,5726,1933900,948600
3456,269,283,310110,5707,1934183,958400
3457,253,283,309844,5690,1934466,939400
3458,254,299,309593,5642,1934765,939400
3459,276,309,309319,5607,1935074,960000
3460,275,297,309033,5596,1935371,1020600
3461,266,285,308770,5574,1935656,960200
3462,283,309,308492,5543,1935965,941000
3463,285,284,308210,5541,1936249,951600
3464,277,291,307940,5520,1936540,946500
3465,256,320,307674,5466,1936860,934100
3466,273,275,307404,5461,1937135,995800
3467,266,274,307135,5456,1937409,964900
3468,288,269,306850,5472,1937678,934000
3469,265,276,306593,5453,1937954,916600
3470,268,251,306328,5467,1938205,980700
3471,300,271,306017,5507,1938476,982000
3472,269,271,305757,5496,1938747,1145500
3473,298,302,305453,5498,1939049,999400
3474,299,272,305162,5517,1939321,948800
3475,286,271,304878,5530,1939592,963500
3476,326,248,304546,5614,1939840,965100
3477,278,274,304269,5617,1940114,1007100
3478,296,315,303985,5586,1940429,1008800
3479,275,307,303702,5562,1940736,1041600
3480,324,284,303378,5602,1941020,1203900
3481,297,296,303079,5605,1941316,1029000
3482,282,301,302810,5573,1941617,1015000
3483,272,287,302509,5587,1941904,980400
3484,315,306,302214,5576,1942210,1008000
3485,279,283,301915,5592,1942493,965900
3486,304,289,301640,5578,1942782,993600
3487,257,287,301352,5579,1943069,967100
3488,282,252,301095,5584,1943321,914700
3489,301,261,300774,5644,1943582,971700
3490,294,277,300478,5663,1943859,990600
3491,290,293,300197,5651,1944152,929400
3492,283,285,299919,5644,1944437,941100
3493,261,274,299647,5642,1944711,993700
3494,270,319,299387,5583,1945030,940000
3495,286,277,299109,5584,1945307,973800
3496,283,308,298816,5569,1945615,927600
3497,297,287,298522,5576,1945902,1033700
3498,325,289,298203,5606,1946191,1022500
3499,271,289,297911,5609,1946480,962800
3500,282,303,297636,5581,1946783,1000400
3501,299,277,297347,5593,1947060,941500
3502,308,269,297041,5630,1947329,933600
3503,296,291,296737,5643,1947620,984500
3504,283,287,296447,5646,1947907,982300
3505,274,269,296186,5638,1948176,950900
3506,299,300,295875,5649,1948476,961600
3507,285,320,295600,5604,1948796,968300
3508,300,301,295303,5600,1949097,935500
3509,286,276,295016,5611,1949373,924100
3510,287,294,294708,5625,1949667,953700
3511,283,311,294442,5580,1949978,945500
3512,293,276,294144,5602,1950254,929400
3513,307,274,293833,5639,1950528,1022500
3514,297,297,293549,5626,1950825,948900
3515,289,311,293254,5610,1951136,995500
3516,297,301,292961,5602,1951437,1011300
3517,268,285,292691,5587,1951722,1000500
3518,282,293,292402,5583,1952015,942200
3519,288,287,292126,5572,1952302,954000
3520,325,275,291818,5605,1952577,943100
3521,297,278,291501,5644,1952855,937600
3522,278,285,291223,5637,1953140,934000
3523,310,271,290906,5683,1953411,916900
3524,293,298,290615,5676,1953709,928100
3525,320,256,290294,5741,1953965,971800
3526,310,303,289997,5735,1954268,922100
3527,305,308,289670,5754,1954576,934600
3528,296,330,289385,5709,1954906,922200
3529,297,292,289086,5716,1955198,954200
3530,317,285,288767,5750,1955483,1012200
3531,300,291,288469,5757,1955774,1022700
3532,275,319,288208,5699,1956093,960200
3533,311,283,287883,5741,1956376,961800
3534,294,306,287590,5728,1956682,943200
3535,280,286,287302,5730,1956968,936100
3536,249,280,287046,5706,1957248,953400
3537,301,302,286759,5691,1957550,927200
3538,263,267,286499,5684,1957817,924900
3539,270,286,286223,5674,1958103,902600
3540,259,328,285960,5609,1958431,962800
3541,275,284,285682,5603,1958715,1043600
3542,309,297,285390,5598,1959012,1007200
3543,323,311,285084,5593,1959323,939100
3544,283,273,284772,5632,1959596,980000
3545,302,255,284484,5665,1959851,1155000
3546,291,307,284186,5656,1960158,1046500
3547,302,306,283882,5654,1960464,1043100
3548,284,315,283593,5628,1960779,994000
3549,281,306,283320,5595,1961085,946500
3550,291,274,283026,5615,1961359,1268300
3551,304,291,282726,5624,1961650,1006000
3552,281,316,282447,5587,1961966,961300
3553,299,311,282152,5571,1962277,951200
3554,259,278,281871,5574,1962555,924000
3555,290,309,281604,5532,1962864,915600
3556,281,279,281308,5549,1963143,916600
3557,241,255,281060,5542,1963398,915000
3558,268,287,280800,5515,1963685,915200
3559,254,278,280543,5494,1963963,926700
3560,233,293,280309,5435,1964256,941700
3561,279,265,280033,5446,1964521,1103400
3562,272,303,279782,5394,1964824,1006400
3563,278,286,279481,5409,1965110,953800
3564,254,307,279220,5363,1965417,934200
3565,266,262,278971,5350,1965679,974100
3566,270,294,278691,5336,1965973,935800
3567,278,264,278422,5341,1966237,930700
3568,260,273,278152,5338,1966510,930100
3569,265,310,277891,5289,1966820,937200
3570,250,247,277637,5296,1967067,953200
3571,271,273,277379,5281,1967340,942400
3572,274,288,277093,5279,1967628,989100
3573,257,239,276838,5295,1967867,946700
3574,291,267,276550,5316,1968134,952500
3575,279,280,276273,5313,1968414,929200
3576,259,279,276009,5298,1968693,939700
3577,262,259,275751,5297,1968952,986600
3578,278,293,275473,5282,1969245,1045600
3579,261,303,275216,5236,1969548,993000
3580,249,271,274972,5209,1969819,980300
3581,262,279,274689,5213,1970098,979100
3582,240,279,274460,5163,1970377,987800
3583,245,262,274217,5144,1970639,944000
3584,260,274,273955,5132,1970913,925900
3585,268,262,273692,5133,1971175,897200
3586,231,281,273450,5094,1971456,951600
3587,248,260,273207,5077,1971716,926700
3588,259,260,272944,5080,1971976,929900
3589,240,250,272708,5066,1972226,946300
3590,250,258,272461,5055,1972484,1008700
3591,279,283,272182,5051,1972767,950600
3592,243,274,271929,5030,1973041,938800
3593,252,270,271680,5009,1973311,1064300
3594,262,255,271421,5013,1973566,1024400
3595,248,270,271168,4996,1973836,1194100
3596,242,272,270926,4966,1974108,954400
3597,256,269,270666,4957,1974377,935300
3598,254,265,270419,4939,1974642,937600
3599,241,258,270177,4923,1974900,911400
3600,251,268,269927,4905,1975168,967600
3601,279,260,269654,4918,1975428,932000
3602,225,249,269423,4900,1975677,950100
3603,252,257,269175,4891,1975934,964400
3604,263,245,268914,4907,1976179,934000
3605,260,247,268643,4931,1976426,918700
3606,236,236,268413,4925,1976662,1006900
3607,275,275,268146,4917,1976937,917800
3608,226,277,267910,4876,1977214,1034400
3609,307,242,267605,4939,1977456,1089600
3610,299,279,267308,4957,1977735,1026700
3611,250,231,267059,4975,1977966,963300
3612,278,257,266780,4997,1978223,1067600
3613,285,274,266503,5000,1978497,1065000
3614,263,284,266240,4979,1978781,1114800
3615,259,269,265977,4973,1979050,1044000
3616,232,296,265735,4919,1979346,985200
3617,249,259,265484,4911,1979605,1042000
3618,242,266,265255,4874,1979871,1007400
3619,251,243,264985,4901,1980114,963900
3620,317,235,264697,4954,1980349,951700
3621,279,266,264409,4976,1980615,932700
3622,272,247,264130,5008,1980862,948700
3623,235,271,263892,4975,1981133,945000
3624,266,260,263627,4980,1981393,946000
3625,271,240,263362,5005,1981633,932700
3626,258,266,263091,5010,1981899,996900
3627,296,252,262811,5038,1982151,958900
3628,270,246,262552,5051,1982397,947700
3629,268,258,262262,5083,1982655,1000300
3630,286,240,261985,5120,1982895,938700
3631,259,264,261713,5128,1983159,942800
3632,249,275,261467,5099,1983434,916000
3633,266,270,261199,5097,1983704,993400
3634,243,243,260950,5103,1983947,942500
3635,257,241,260704,5108,1984188,935900
3636,273,248,260438,5126,1984436,952800
3637,271,271,260174,5119,1984707,955800
3638,263,251,259890,5152,1984958,940200
3639,257,227,259651,5164,1985185,931000
3640,260,242,259383,5190,1985427,922400
3641,249,256,259125,5192,1985683,992800
3642,294,286,258835,5196,1985969,961800
3643,260,301,258574,5156,1986270,964900
3644,285,291,258301,5138,1986561,933500
3645,292,245,258004,5190,1986806,958600
3646,284,257,257718,5219,1987063,938800
3647,263,276,257453,5208,1987339,924900
3648,262,262,257187,5212,1987601,917800
3649,271,269,256927,5203,1987870,916400
3650,271,228,256655,5247,1988098,916200
3651,271,286,256390,5226,1988384,917800
3652,261,266,256126,5224,1988650,932300
3653,260,289,255865,5196,1988939,926700
3654,262,267,255597,5197,1989206,998900
3655,258,260,255346,5188,1989466,941500
3656,259,276,255081,5177,1989742,939500
3657,237,262,254826,5170,1990004,962800
3658,238,273,254604,5119,1990277,951400
3659,234,265,254375,5083,1990542,989900
3660,246,260,254125,5073,1990802,949800
3661,247,265,253864,5069,1991067,926200
3662,267,257,253609,5067,1991324,933500
3663,250,261,253358,5057,1991585,930900
3664,286,272,253081,5062,1991857,967700
3665,253,257,252813,5073,1992114,974500
3666,245,256,252570,5060,1992370,935900
3667,264,261,252309,5060,1992631,938500
3668,247,253,252063,5053,1992884,924700
3669,236,273,251825,5018,1993157,926900
3670,261,260,251566,5017,1993417,928100
3671,254,228,251319,5036,1993645,908400
3672,256,236,251056,5063,1993881,922400
3673,305,280,250761,5078,1994161,1049600
3674,262,264,250486,5089,1994425,974100
3675,256,264,250233,5078,1994689,969100
3676,282,261,249948,5102,1994950,966600
3677,232,249,249722,5079,1995199,1006600
3678,240,267,249476,5058,1995466,968500
3679,226,251,249253,5030,1995717,933300
3680,262,252,248998,5033,1995969,956600
3681,264,259,248719,5053,1996228,1008700
3682,234,266,248490,5016,1996494,1164100
3683,248,232,248236,5038,1996726,1048000
3684,246,232,248017,5025,1996958,1202500
3685,260,285,247735,5022,1997243,1000800
3686,241,260,247489,5008,1997503,973000
3687,263,270,247235,4992,1997773,1006600
3688,225,269,247005,4953,1998042,1030800
3689,233,261,246773,4924,1998303,953300
3690,248,240,246539,4918,1998543,937600
3691,269,253,246275,4929,1998796,914000
3692,238,255,246026,4923,1999051,937100
3693,245,227,245771,4951,1999278,938500
3694,234,277,245539,4906,1999555,971300
3695,223,259,245318,4868,1999814,987200
3696,256,292,245075,4819,2000106,939700
3697,228,242,244831,4821,2000348,931500
3698,241,277,244598,4777,2000625,954200
3699,257,248,244344,4783,2000873,916700
3700,262,234,244085,4808,2001107,914800
3701,240,257,243843,4793,2001364,935500
3702,261,236,243574,4826,2001600,942200
3703,199,252,243370,4778,2001852,942000
3704,219,239,243146,4763,2002091,1025800
3705,231,248,242919,4742,2002339,1007000
3706,241,227,242696,4738,2002566,959800
3707,221,239,242460,4735,2002805,933200
3708,231,249,242236,4710,2003054,922700
3709,269,242,241960,4744,2003296,928900
3710,242,248,241723,4733,2003544,942400
3711,232,235,241492,4729,2003779,928800
3712,231,245,241257,4719,2004024,921000
3713,228,245,241023,4708,2004269,909700
3714,235,250,240780,4701,2004519,917900
3715,247,245,240557,4679,2004764,996300
3716,233,248,240317,4671,2005012,1034400
3717,232,209,240081,4698,2005221,946300
3718,254,234,239837,4708,2005455,1025600
3719,263,249,239563,4733,2005704,939800
3720,247,273,239326,4697,2005977,1056700
3721,249,259,239072,4692,2006236,1033900
3722,251,255,238813,4696,2006491,1050200
3723,260,241,238579,4689,2006732,1033400
3724,253,237,238315,4716,2006969,1049800
3725,246,284,238073,4674,2007253,1105400
3726,278,217,237793,4737,2007470,1011800
3727,236,250,237554,4726,2007720,1065100
3728,250,254,237291,4735,2007974,976000
3729,271,240,237031,4755,2008214,964700
3730,279,251,236743,4792,2008465,942500
3731,289,267,236469,4799,2008732,963500
3732,265,239,236204,4825,2008971,943700
3733,273,215,235909,4905,2009186,985000
3734,251,241,235682,4891,2009427,946000
3735,274,262,235398,4913,2009689,1002600
3736,266,240,235129,4942,2009929,984200
3737,247,263,234883,4925,2010192,950200
3738,279,226,234612,4970,2010418,970500
3739,256,248,234355,4979,2010666,958000
3740,266,247,234088,4999,2010913,947000
3741,285,267,233813,5007,2011180,927400
3742,271,289,233536,4995,2011469,941700
3743,285,243,233252,5036,2011712,1065500
3744,260,291,232987,5010,2012003,1016400
3745,270,274,232718,5005,2012277,979700
3746,257,260,232459,5004,2012537,1022300
3747,270,266,232193,5004,2012803,1083800
3748,265,235,231912,5050,2013038,1039900
3749,271,269,231654,5039,2013307,1057700
3750,266,293,231380,5020,2013600,1013600
3751,284,252,231101,5047,2013852,999000
3752,249,273,230855,5020,2014125,1010400
3753,264,264,230592,5019,2014389,985900
3754,281,240,230307,5064,2014629,989000
3755,278,296,230042,5033,2014925,996300
3756,265,230,229774,5071,2015155,956800
3757,285,215,229492,5138,2015370,952400
3758,259,267,229217,5146,2015637,931100
3759,286,265,228931,5167,2015902,982300
3760,254,247,228674,5177,2016149,924200
3761,256,265,228436,5150,2016414,932900
3762,230,231,228192,5163,2016645,944000
3763,250,275,227943,5137,2016920,940200
3764,238,244,227707,5129,2017164,922300
3765,246,257,227455,5124,2017421,958400
3766,267,282,227185,5112,2017703,1057900
3767,246,289,226942,5066,2017992,1058700
3768,254,269,226687,5052,2018261,998300
3769,241,263,226445,5031,2018524,1013400
3770,225,267,226217,4992,2018791,968000
3771,235,227,225984,4998,2019018,952800
3772,259,277,225732,4973,2019295,967500
3773,246,259,225477,4969,2019554,964000
3774,273,294,225215,4937,2019848,939600
3775,240,277,224965,4910,2020125,965400
3776,255,263,224715,4897,2020388,1003400
3777,255,195,224462,4955,2020583,990000
3778,254,247,224200,4970,2020830,988400
3779,226,267,223973,4930,2021097,970300
3780,260,250,223723,4930,2021347,976200
3781,269,257,223462,4934,2021604,983700
3782,207,268,223237,4891,2021872,1055900
3783,202,265,223038,4825,2022137,983000
3784,245,268,222782,4813,2022405,980200
3785,243,256,222553,4786,2022661,975500
3786,222,230,222325,4784,2022891,1022100
3787,212,248,222102,4759,2023139,1009700
3788,223,257,221889,4715,2023396,1077100
3789,220,255,221685,4664,2023651,990300
3790,213,260,221454,4635,2023911,975200
3791,207,227,221247,4615,2024138,962100
3792,209,256,221031,4575,2024394,969800
3793,193,230,220844,4532,2024624,955300
3794,181,259,220671,4446,2024883,963100
3795,220,208,220449,4460,2025091,983700
3796,238,222,220211,4476,2025313,1015500
3797,229,239,219993,4455,2025552,1025400
3798,219,246,219757,4445,2025798,1001100
3799,268,221,219499,4482,2026019,947000
3800,265,222,219239,4520,2026241,957300
3801,233,240,219004,4515,2026481,944100
3802,219,238,218775,4506,2026719,976300
3803,255,250,218538,4493,2026969,967700
3804,240,238,218301,4492,2027207,994200
3805,241,242,218034,4517,2027449,971600
3806,272,215,217771,4565,2027664,1034700
3807,266,250,217505,4581,2027914,980200
3808,247,258,217258,4570,2028172,971600
3809,219,231,217033,4564,2028403,974200
3810,236,209,216799,4589,2028612,990400
3811,244,242,216566,4580,2028854,976400
3812,256,250,216301,4595,2029104,978300
3813,238,244,216066,4586,2029348,1083900
3814,211,229,215856,4567,2029577,1138200
3815,197,233,215648,4542,2029810,1074300
3816,225,237,215438,4515,2030047,1129700
3817,219,221,215216,4516,2030268,1115200
3818,241,225,214976,4531,2030493,1054000
3819,235,225,214751,4531,2030718,1007000
3820,248,247,214496,4539,2030965,1038900
3821,220,237,214272,4526,2031202,1157700
3822,268,228,214001,4569,2031430,1112400
3823,273,221,213724,4625,2031651,1144100
3824,221,253,213499,4597,2031904,1106600
3825,247,237,213256,4603,2032141,1087700
3826,270,220,212999,4640,2032361,1232300
3827,243,252,212753,4634,2032613,1057300
3828,259,227,212500,4660,2032840,1152100
3829,262,228,212234,4698,2033068,1082900
3830,243,249,211977,4706,2033317,1039100
3831,243,234,211738,4711,2033551,1076000
3832,223,231,211506,4712,2033782,1055300
3833,236,267,211282,4669,2034049,1037500
3834,219,238,211067,4646,2034287,1099400
3835,216,250,210843,4620,2034537,1038100
3836,202,243,210644,4576,2034780,1061800
3837,225,245,210420,4555,2035025,1072700
3838,210,231,210207,4537,2035256,1040200
3839,227,239,209977,4528,2035495,1040900
3840,202,236,209771,4498,2035731,1063200
3841,201,228,209581,4460,2035959,1052600
3842,216,223,209363,4455,2036182,1053500
3843,223,217,209140,4461,2036399,1052400
3844,198,237,208941,4423,2036636,1052300
3845,212,211,208727,4426,2036847,982300
3846,198,224,208528,4401,2037071,988700
3847,206,237,208317,4375,2037308,939800
3848,223,224,208111,4357,2037532,968300
3849,223,223,207886,4359,2037755,991500
3850,236,208,207642,4395,2037963,966900
3851,208,219,207441,4377,2038182,996500
3852,236,213,207204,4401,2038395,987400
3853,223,215,206974,4416,2038610,1031200
3854,230,225,206751,4414,2038835,1029100
3855,235,219,206513,4433,2039054,1043800
3856,203,208,206304,4434,2039262,990700
3857,238,214,206071,4453,2039476,954000
3858,201,248,205865,4411,2039724,994800
3859,224,208,205638,4430,2039932,1040600
3860,213,216,205436,4416,2040148,1000700
3861,234,229,205200,4423,2040377,974600
3862,261,237,204943,4443,2040614,966800
3863,234,225,204708,4453,2040839,1010700
3864,232,215,204471,4475,2041054,1035000
3865,222,237,204246,4463,2041291,1041800
3866,231,222,204028,4459,2041513,996500
3867,236,225,203776,4486,2041738,1000800
3868,190,258,203583,4421,2041996,985000
3869,233,244,203362,4398,2042240,982200
3870,232,219,203123,4418,2042459,987700
3871,226,218,202901,4422,2042677,983400
3872,201,244,202695,4384,2042921,983700
3873,226,212,202484,4383,2043133,1083500
3874,216,227,202261,4379,2043360,1142600
3875,231,231,202038,4371,2043591,1080500
3876,226,225,201793,4391,2043816,947700
3877,261,240,201547,4397,2044056,936300
3878,221,230,201323,4391,2044286,1078600
3879,211,205,201112,4397,2044491,1024200
3880,215,203,200885,4421,2044694,1103700
3881,222,215,200670,4421,2044909,1045800
3882,226,209,200450,4432,2045118,1020900
3883,219,217,200225,4440,2045335,1055800
3884,220,217,200016,4432,2045552,1104600
3885,227,238,199772,4438,2045790,1001600
3886,211,234,199561,4415,2046024,951500
3887,232,228,199349,4399,2046252,924300
3888,219,215,199110,4423,2046467,1015700
3889,239,201,198898,4434,2046668,1117700
3890,223,229,198654,4449,2046897,1050700
3891,230,263,198429,4411,2047160,1096700
3892,212,223,198212,4405,2047383,1054900
3893,214,233,197993,4391,2047616,1055500
3894,219,246,197772,4366,2047862,1058800
3895,241,218,197546,4374,2048080,1002500
3896,236,198,197309,4413,2048278,1069600
3897,214,226,197091,4405,2048504,983800
3898,227,254,196864,4378,2048758,1014500
3899,209,234,196649,4359,2048992,988300
3900,207,233,196440,4335,2049225,1003300
3901,226,202,196211,4362,2049427,1032600
3902,226,241,195995,4337,2049668,1046700
3903,236,222,195761,4349,2049890,1125000
3904,243,231,195517,4362,2050121,1112900
3905,220,236,195297,4346,2050357,1057300
3906,233,229,195076,4338,2050586,1017300
3907,232,213,194837,4364,2050799,1044100
3908,246,220,194584,4397,2051019,1033200
3909,225,224,194371,4386,2051243,976500
3910,237,211,194129,4417,2051454,1018500
3911,236,257,193888,4401,2051711,1012300
3912,212,230,193667,4392,2051941,1110900
3913,224,220,193444,4395,2052161,1010000
3914,244,218,193218,4403,2052379,1075100
3915,206,226,192999,4396,2052605,1054000
3916,204,233,192796,4366,2052838,1036400
3917,262,216,192533,4413,2053054,1013800
3918,240,194,192306,4446,2053248,1024300
3919,246,235,192050,4467,2053483,1034300
3920,250,248,191801,4468,2053731,1060500
3921,229,230,191562,4477,2053961,1087300
3922,220,226,191348,4465,2054187,1028000
3923,246,228,191105,4480,2054415,996500
3924,218,258,190891,4436,2054673,992100
3925,230,220,190663,4444,2054893,1008400
3926,237,222,190422,4463,2055115,1020600
3927,243,228,190181,4476,2055343,1098000
3928,212,248,189965,4444,2055591,1046700
3929,226,276,189742,4391,2055867,1058400
3930,230,219,189532,4382,2056086,1123300
3931,224,230,189281,4403,2056316,1126300
3932,219,235,189065,4384,2056551,1120800
3933,205,205,188861,4383,2056756,1058500
3934,232,215,188620,4409,2056971,1106200
3935,247,221,188379,4429,2057192,1116200
3936,228,237,188156,4415,2057429,1069000
3937,248,216,187919,4436,2057645,1058100
3938,241,213,187672,4470,2057858,998800
3939,246,227,187411,4504,2058085,1157100
3940,214,236,187201,4478,2058321,1085300
3941,228,228,186982,4469,2058549,1007800
3942,236,238,186749,4464,2058787,1047800
3943,217,246,186528,4439,2059033,1107300
3944,218,238,186299,4430,2059271,1165300
3945,192,220,186108,4401,2059491,1157100
3946,248,236,185870,4403,2059727,1193400
3947,243,241,185626,4406,2059968,1335100
3948,203,206,185409,4417,2060174,1288100
3949,240,256,185174,4396,2060430,1296100
3950,240,213,184936,4421,2060643,1130300
3951,222,243,184719,4395,2060886,1166600
3952,245,230,184474,4410,2061116,1294200
3953,258,250,184214,4420,2061366,1388300
3954,226,220,183996,4418,2061586,1164600
3955,215,238,183769,4407,2061824,1080200
3956,185,236,183580,4360,2062060,1241200
3957,205,241,183376,4323,2062301,1086800
3958,219,212,183169,4318,2062513,1047000
3959,210,254,182945,4288,2062767,1032700
3960,209,217,182739,4277,2062984,1051700
3961,226,224,182517,4275,2063208,1020900
3962,235,227,182288,4277,2063435,1017000
3963,194,237,182082,4246,2063672,993400
3964,197,229,181890,4209,2063901,1018000
3965,180,196,181708,4195,2064097,959400
3966,207,219,181505,4179,2064316,986000
3967,221,187,181274,4223,2064503,1021300
3968,215,199,181065,4233,2064702,975900
3969,216,191,180854,4253,2064893,1007300
3970,219,224,180647,4236,2065117,961800
3971,233,217,180410,4256,2065334,1009100
3972,228,234,180169,4263,2065568,986100
3973,208,219,179965,4248,2065787,931900
3974,218,212,179749,4252,2065999,945900
3975,250,223,179503,4275,2066222,970700
3976,230,220,179288,4270,2066442,1002200
3977,201,212,179052,4294,2066654,1066500
3978,237,219,178833,4294,2066873,1167200
3979,212,219,178612,4296,2067092,992000
3980,231,217,178390,4301,2067309,1007900
3981,225,192,178159,4340,2067501,948500
3982,245,231,177934,4334,2067732,984400
3983,200,228,177717,4323,2067960,949600
3984,202,227,177514,4299,2068187,960700
3985,233,224,177287,4302,2068411,955000
3986,222,213,177056,4320,2068624,985600
3987,208,228,176840,4308,2068852,993300
3988,211,211,176644,4293,2069063,1008300
3989,236,220,176404,4313,2069283,986200
3990,217,222,176187,4308,2069505,925400
3991,208,247,175975,4273,2069752,950600
3992,235,234,175750,4264,2069986,1012300
3993,224,212,175523,4279,2070198,984200
3994,188,220,175328,4254,2070418,964900
3995,216,233,175125,4224,2070651,1005400
3996,244,224,174887,4238,2070875,1028800
3997,224,215,174658,4252,2071090,944300
3998,236,206,174403,4301,2071296,979600
3999,219,221,174205,4278,2071517,940300
4000,205,211,173989,4283,2071728,931900
4001,204,196,173785,4291,2071924,1005100
4002,208,241,173566,4269,2072165,938700
4003,227,237,173360,4238,2072402,1067300
4004,210,212,173141,4245,2072614,1004600
4005,220,204,172920,4262,2072818,1109600
4006,226,209,172688,4285,2073027,1130400
4007,196,228,172487,4258,2073255,1206700
4008,217,190,172281,4274,2073445,1111700
4009,207,230,172075,4250,2073675,1094400
4010,219,200,171864,4261,2073875,1057000
4011,214,247,171646,4232,2074122,1117300
4012,224,245,171421,4212,2074367,1038900
4013,224,212,171186,4235,2074579,1059700
4014,222,234,170970,4217,2074813,963800
4015,203,227,170766,4194,2075040,1013600
4016,220,204,170543,4213,2075244,961800
4017,205,206,170340,4210,2075450,1016200
4018,219,223,170116,4211,2075673,959800
4019,204,213,169917,4197,2075886,965600
4020,201,231,169717,4166,2076117,955100
4021,202,225,169523,4135,2076342,968300
4022,248,220,169278,4160,2076562,1089000
4023,222,219,169049,4170,2076781,1177900
4024,237,221,168802,4196,2077002,1143200
4025,233,230,168581,4187,2077232,1111700
4026,200,201,168371,4196,2077433,1018600
4027,201,219,168167,4181,2077652,1078700
4028,228,193,167958,4197,2077845,970300
4029,229,203,167724,4228,2078048,1093500
4030,206,244,167516,4192,2078292,978200
4031,178,221,167322,4165,2078513,960700
4032,222,238,167117,4132,2078751,967000
4033,220,226,166889,4134,2078977,930700
4034,200,210,166698,4115,2079187,927100
4035,233,221,166453,4139,2079408,1043500
4036,225,234,166235,4123,2079642,988700
4037,211,205,166021,4132,2079847,1059100
4038,190,216,165825,4112,2080063,997100
4039,231,212,165616,4109,2080275,1028500
4040,224,216,165371,4138,2080491,1252900
4041,219,211,165171,4127,2080702,1104000
4042,243,225,164915,4158,2080927,1034600
4043,229,224,164687,4162,2081151,1014600
4044,236,197,164435,4217,2081348,1077800
4045,214,197,164246,4209,2081545,1032000
4046,219,227,164009,4219,2081772,993000
4047,224,206,163802,4220,2081978,1035400
4048,209,215,163600,4207,2082193,1636600
4049,225,230,163366,4211,2082423,1034700
4050,208,211,163161,4205,2082634,1036700
4051,218,216,162929,4221,2082850,1035300
4052,215,215,162723,4212,2083065,993800
4053,221,207,162503,4225,2083272,1078400
4054,209,225,162292,4211,2083497,977800
4055,209,211,162084,4208,2083708,958000
4056,235,239,161846,4207,2083947,957500
4057,222,219,161637,4197,2084166,972400
4058,222,238,161394,4202,2084404,951800
4059,245,229,161160,4207,2084633,926500
4060,210,245,160943,4179,2084878,970400
4061,205,203,160739,4180,2085081,917200
4062,231,221,160519,4179,2085302,967900
4063,203,236,160311,4151,2085538,1014800
4064,201,208,160094,4160,2085746,998400
4065,222,211,159896,4147,2085957,1046700
4066,255,201,159631,4211,2086158,1164000
4067,231,214,159405,4223,2086372,1020300
4068,221,209,159176,4243,2086581,1007100
4069,208,224,158978,4217,2086805,1026300
4070,222,231,158760,4204,2087036,1031900
4071,215,222,158535,4207,2087258,1042300
4072,224,231,158321,4190,2087489,1014100
4073,222,206,158093,4212,2087695,1006200
4074,202,222,157889,4194,2087917,986400
4075,211,248,157664,4171,2088165,1183800
4076,180,207,157486,4142,2088372,1057900
4077,205,218,157284,4126,2088590,1069400
4078,210,209,157077,4124,2088799,1110100
4079,207,221,156863,4117,2089020,1059400
4080,186,207,156680,4093,2089227,1010900
4081,203,208,156484,4081,2089435,1089600
4082,197,222,156292,4051,2089657,1039900
4083,209,198,156068,4077,2089855,982700
4084,209,211,155870,4064,2090066,952900
4085,211,201,155653,4080,2090267,1009400
4086,217,228,155444,4061,2090495,966900
4087,205,222,155236,4047,2090717,972600
4088,204,207,155024,4052,2090924,1002500
4089,206,209,154833,4034,2091133,939900
4090,197,212,154623,4032,2091345,934100
4091,202,198,154428,4029,2091543,1022900
4092,215,213,154214,4030,2091756,1030500
4093,189,181,154023,4040,2091937,1005000
4094,202,212,153827,4024,2092149,1032100
4095,205,204,153616,4031,2092353,980000
4096,211,221,153401,4025,2092574,996700
4097,211,243,153185,3998,2092817,1045300
4098,213,222,152973,3988,2093039,1070900
4099,218,200,152763,3998,2093239,971600
4100,208,208,152558,3995,2093447,966900
4101,229,218,152327,4008,2093665,968100
4102,225,213,152104,4018,2093878,999600
4103,215,209,151888,4025,2094087,933100
4104,217,191,151676,4046,2094278,1026500
4105,225,228,151442,4052,2094506,961600
4106,197,219,151239,4036,2094725,931400
4107,219,184,151033,4058,2094909,972300
4108,232,239,150810,4042,2095148,1022300
4109,198,207,150606,4039,2095355,949300
4110,198,197,150390,4058,2095552,961700
4111,228,205,150178,4065,2095757,1074600
4112,226,195,149949,4099,2095952,1067000
4113,227,205,149722,4121,2096157,1006200
4114,192,212,149522,4109,2096369,1001200
4115,210,200,149308,4123,2096569,974000
4116,227,214,149087,4130,2096783,960200
4117,214,205,148873,4139,2096988,973100
4118,234,220,148641,4151,2097208,966300
4119,238,219,148404,4169,2097427,945000
4120,226,191,148178,4204,2097618,957100
4121,206,212,147971,4199,2097830,990200
4122,232,236,147744,4190,2098066,977500
4123,228,209,147509,4216,2098275,957600
4124,221,234,147295,4196,2098509,930900
4125,230,239,147067,4185,2098748,971000
4126,200,226,146852,4174,2098974,954400
4127,199,206,146656,4164,2099180,987100
4128,223,208,146437,4175,2099388,995500
4129,219,184,146220,4208,2099572,988200
4130,213,227,146012,4189,2099799,982000
4131,188,212,145817,4172,2100011,950300
4132,211,221,145598,4170,2100232,1081400
4133,201,197,145401,4170,2100429,1006500
4134,214,208,145193,4170,2100637,964500
4135,212,190,144970,4203,2100827,1000500
4136,215,191,144767,4215,2101018,1050400
4137,207,209,144558,4215,2101227,1038000
4138,216,200,144336,4237,2101427,1035000
4139,219,240,144124,4209,2101667,1030300
4140,203,201,143917,4215,2101868,979100
4141,213,241,143712,4179,2102109,1046700
4142,215,224,143484,4183,2102333,1019700
4143,212,228,143283,4156,2102561,989800
4144,249,210,143038,4191,2102771,1042700
4145,231,239,142809,4181,2103010,993700
4146,202,234,142600,4156,2103244,936300
4147,217,213,142389,4154,2103457,974000
4148,207,209,142174,4160,2103666,980200
4149,192,244,141980,4110,2103910,978100
4150,223,216,141766,4108,2104126,923500
4151,201,223,141560,4091,2104349,999000
4152,211,239,141343,4069,2104588,1158000
4153,177,224,141156,4032,2104812,961700
4154,174,199,140979,4010,2105011,1011600
4155,194,214,140804,3971,2105225,1015500
4156,189,201,140604,3970,2105426,956700
4157,221,220,140388,3966,2105646,961700
4158,206,211,140192,3951,2105857,994100
4159,213,218,139972,3953,2106075,986000
4160,224,230,139757,3938,2106305,988500
4161,226,205,139517,3973,2106510,968700
4162,206,210,139319,3961,2106720,963800
4163,217,226,139096,3958,2106946,969700
4164,195,174,138909,3971,2107120,949200
4165,203,190,138696,3994,2107310,958100
4166,231,207,138474,4009,2107517,931700
4167,178,223,138277,3983,2107740,963300
4168,194,207,138092,3961,2107947,1002000
4169,201,208,137891,3954,2108155,984600
4170,206,218,137682,3945,2108373,982600
4171,195,219,137491,3917,2108592,978300
4172,204,205,137288,3915,2108797,937400
4173,195,218,137089,3896,2109015,957500
4174,186,232,136902,3851,2109247,1004400
4175,187,203,136714,3836,2109450,1048700
4176,174,224,136537,3789,2109674,1122000
4177,214,174,136345,3807,2109848,1184800
4178,201,198,136130,3824,2110046,1065400
4179,190,201,135942,3811,2110247,997200
4180,187,225,135748,3780,2110472,1188600
4181,152,184,135602,3742,2110656,1002900
4182,183,212,135419,3713,2110868,1044000
4183,178,196,135236,3700,2111064,1020000
4184,173,209,135066,3661,2111273,993500
4185,172,176,134893,3658,2111449,968000
4186,163,192,134725,3634,2111641,1002500
4187,178,185,134560,3614,2111826,1014600
4188,186,169,134374,3631,2111995,998900
4189,199,163,134175,3667,2112158,1063400
4190,197,196,133976,3670,2112354,997100
4191,197,189,133778,3679,2112543,1055000
4192,174,166,133601,3690,2112709,1037400
4193,198,193,133401,3697,2112902,995600
4194,184,195,133227,3676,2113097,1012100
4195,203,196,133021,3686,2113293,970400
4196,188,208,132824,3675,2113501,982800
4197,187,190,132638,3671,2113691,1127900
4198,192,198,132449,3662,2113889,1067200
4199,197,187,132248,3676,2114076,1012500
4200,199,191,132064,3669,2114267,1079500
4201,192,176,131863,3694,2114443,1115400
4202,200,198,131662,3697,2114641,1180600
4203,204,200,131452,3707,2114841,1151300
4204,220,198,131247,3714,2115039,1147600
4205,208,182,131032,3747,2115221,1103300
4206,206,202,130813,3764,2115423,1074700
4207,188,186,130640,3751,2115609,1049000
4208,170,213,130462,3716,2115822,997200
4209,214,181,130258,3739,2116003,980900
4210,191,184,130071,3742,2116187,1010800
4211,196,202,129858,3753,2116389,1034300
4212,216,177,129659,3775,2116566,1014400
4213,200,184,129446,3804,2116750,1002400
4214,180,182,129264,3804,2116932,1021600
4215,205,172,129078,3818,2117104,1033200
4216,194,189,128870,3837,2117293,1031600
4217,185,185,128689,3833,2117478,1018900
4218,194,210,128487,3825,2117688,1000700
4219,198,192,128301,3819,2117880,1022000
4220,209,202,128089,3829,2118082,1068500
4221,192,202,127896,3820,2118284,1063500
4222,200,228,127691,3797,2118512,1058500
4223,216,179,127473,3836,2118691,1011100
4224,214,209,127260,3840,2118900,980200
4225,187,218,127073,3809,2119118,1018200
4226,202,225,126880,3777,2119343,985200
4227,196,200,126673,3784,2119543,1004700
4228,199,204,126472,3781,2119747,984300
4229,198,175,126277,3801,2119922,1024000
4230,183,192,126095,3791,2120114,1049000
4231,231,205,125880,3801,2120319,991100
4232,206,180,125655,3846,2120499,959300
4233,210,210,125461,3830,2120709,951000
4234,186,206,125272,3813,2120915,959600
4235,179,186,125077,3822,2121101,999200
4236,202,202,124881,3816,2121303,962400
4237,190,208,124689,3800,2121511,1007000
4238,234,196,124462,3831,2121707,943800
4239,218,198,124247,3848,2121905,975100
4240,202,204,124039,3852,2122109,1013000
4241,210,204,123843,3844,2122313,973000
4242,194,175,123637,3875,2122488,926300
4243,195,205,123438,3869,2122693,941700
4244,187,203,123255,3849,2122896,1009300
4245,191,209,123060,3835,2123105,984700
4246,196,187,122870,3838,2123292,951000
4247,175,191,122688,3829,2123483,938900
4248,169,240,122517,3760,2123723,987400
4249,191,194,122333,3750,2123917,964800
4250,193,212,122142,3729,2124129,995900
4251,189,187,121955,3729,2124316,986900
4252,216,214,121735,3735,2124530,966900
4253,196,182,121547,3741,2124712,927900
4254,166,209,121373,3706,2124921,977400
4255,196,197,121184,3698,2125118,1039200
4256,179,171,120982,3729,2125289,1002900
4257,208,193,120806,3712,2125482,965200
4258,208,193,120586,3739,2125675,972500
4259,227,172,120356,3797,2125847,975100
4260,208,192,120154,3807,2126039,981000
4261,194,160,119962,3839,2126199,931300
4262,192,212,119764,3825,2126411,986700
4263,170,181,119589,3819,2126592,960900
4264,209,195,119379,3834,2126787,1019100
4265,182,218,119208,3787,2127005,1013000
4266,181,197,119021,3777,2127202,1010100
4267,199,182,118824,3792,2127384,1153500
4268,200,213,118627,3776,2127597,1052200
4269,193,194,118423,3786,2127791,1042100
4270,175,225,118237,3747,2128016,1084800
4271,184,197,118056,3731,2128213,1007200
4272,172,197,117891,3699,2128410,967700
4273,197,163,117702,3725,2128573,1064100
4274,180,198,117515,3714,2128771,960000
4275,190,217,117325,3687,2128988,990800
4276,180,185,117152,3675,2129173,1001000
4277,203,208,116950,3669,2129381,948700
4278,182,188,116768,3663,2129569,961800
4279,189,164,116575,3692,2129733,968400
4280,158,183,116406,3678,2129916,971600
4281,184,175,116238,3671,2130091,981600
4282,164,195,116059,3655,2130286,966000
4283,197,162,115866,3686,2130448,961700
4284,200,221,115662,3669,2130669,968300
4285,205,212,115467,3652,2130881,971000
4286,179,154,115276,3689,2131035,980900
4287,186,190,115100,3675,2131225,944200
4288,207,213,114890,3672,2131438,951100
4289,186,200,114699,3663,2131638,956800
4290,207,193,114499,3670,2131831,953400
4291,196,194,114305,3670,2132025,1032800
4292,221,193,114085,3697,2132218,985600
4293,235,178,113860,3744,2132396,932500
4294,201,190,113651,3763,2132586,956500
4295,187,213,113465,3736,2132799,930300
4296,183,185,113278,3738,2132984,996300
4297,218,216,113059,3741,2133200,977500
4298,190,184,112882,3734,2133384,961700
4299,201,238,112666,3712,2133622,975300
4300,180,190,112496,3692,2133812,961400
4301,193,225,112288,3675,2134037,1009100
4302,176,182,112107,3674,2134219,959300
4303,218,182,111918,3681,2134401,974600
4304,186,180,111714,3705,2134581,999900
4305,176,224,111548,3647,2134805,952100
4306,193,197,111346,3652,2135002,943700
4307,206,187,111140,3671,2135189,932900
4308,186,180,110953,3678,2135369,940300
4309,206,179,110746,3706,2135548,957300
4310,175,189,110568,3695,2135737,979000
4311,179,175,110386,3702,2135912,992900
4312,199,190,110188,3710,2136102,982400
4313,185,187,109997,3714,2136289,1071500
4314,210,205,109805,3701,2136494,943000
4315,181,197,109628,3681,2136691,971200
4316,185,193,109437,3679,2136884,944800
4317,206,184,109220,3712,2137068,959500
4318,192,178,109032,3722,2137246,973400
4319,197,174,108838,3742,2137420,1002400
4320,192,193,108642,3745,2137613,1022100
4321,177,191,108461,3735,2137804,961600
4322,196,187,108281,3728,2137991,1021500
4323,207,204,108081,3724,2138195,969400
4324,176,198,107895,3712,2138393,982700
4325,211,182,107675,3750,2138575,979100
4326,179,193,107496,3736,2138768,979600
4327,216,194,107280,3758,2138962,955500
4328,186,194,107088,3756,2139156,1037500
4329,216,203,106892,3749,2139359,1017000
4330,198,196,106682,3763,2139555,964700
4331,186,203,106490,3752,2139758,1026600
4332,182,207,106311,3724,2139965,1007600
4333,169,189,106145,3701,2140154,981800
4334,226,205,105925,3716,2140359,948000
4335,199,183,105722,3736,2140542,1022700
4336,195,197,105525,3736,2140739,1021600
4337,173,178,105349,3734,2140917,1048800
4338,197,194,105165,3724,2141111,1045600
4339,192,186,104957,3746,2141297,969900
4340,190,193,104773,3737,2141490,986800
4341,205,225,104570,3715,2141715,1010700
4342,192,174,104377,3734,2141889,982200
4343,178,197,104197,3717,2142086,971500
4344,210,192,103997,3725,2142278,974300
4345,196,180,103798,3744,2142458,1040500
4346,182,204,103619,3719,2142662,972100
4347,175,195,103437,3706,2142857,972900
4348,157,185,103280,3678,2143042,904500
4349,167,175,103101,3682,2143217,943400
4350,188,179,102928,3676,2143396,1032000
4351,193,173,102736,3695,2143569,1135300
4352,186,182,102539,3710,2143751,1005900
4353,183,167,102359,3723,2143918,954400
4354,212,188,102161,3733,2144106,979600
4355,236,197,101926,3771,2144303,958500
4356,222,193,101689,3815,2144496,939100
4357,197,174,101494,3836,2144670,958200
4358,205,210,101302,3818,2144880,962900
4359,200,189,101104,3827,2145069,1000500
4360,189,187,100908,3836,2145256,992700
4361,190,179,100710,3855,2145435,983900
4362,218,198,100504,3863,2145633,951800
4363,210,194,100291,3882,2145827,938100
4364,199,186,100093,3894,2146013,942700
4365,203,210,99882,3895,2146223,1012200
4366,221,216,99662,3899,2146439,956300
4367,193,220,99459,3882,2146659,967500
4368,194,215,99272,3854,2146874,949300
4369,189,210,99087,3829,2147084,918300
4370,182,186,98892,3838,2147270,969900
4371,208,202,98694,3834,2147472,971200
4372,190,190,98500,3838,2147662,990700
4373,174,169,98319,3850,2147831,962200
4374,197,211,98137,3821,2148042,960400
4375,169,162,97961,3835,2148204,990600
4376,197,197,97761,3838,2148401,995300
4377,194,195,97576,3828,2148596,1016500
4378,166,176,97410,3818,2148772,947800
4379,190,196,97216,3816,2148968,993400
4380,182,201,97043,3788,2149169,958700
4381,197,211,96834,3786,2149380,993800
4382,158,183,96676,3761,2149563,956200
4383,178,193,96505,3739,2149756,966800
4384,170,198,96331,3715,2149954,952200
4385,168,197,96157,3692,2150151,944600
4386,168,180,95998,3671,2150331,933000
4387,194,200,95811,3658,2150531,932000
4388,187,186,95611,3672,2150717,955000
4389,153,169,95448,3666,2150886,944200
4390,211,187,95256,3671,2151073,997500
4391,175,185,95076,3666,2151258,954700
4392,154,196,94933,3613,2151454,1002100
4393,181,163,94743,3640,2151617,1054500
4394,215,195,94527,3661,2151812,989600
4395,188,200,94337,3651,2152012,1028300
4396,209,198,94138,3652,2152210,987800
4397,208,160,93930,3700,2152370,1056500
4398,190,189,93736,3705,2152559,1074000
4399,202,159,93534,3748,2152718,1031100
4400,181,203,93367,3712,2152921,960400
4401,176,188,93170,3721,2153109,1034800
4402,194,202,92977,3712,2153311,1050200
4403,200,193,92779,3717,2153504,1049000
4404,200,224,92577,3695,2153728,1043900
4405,192,180,92399,3693,2153908,1024500
4406,208,194,92180,3718,2154102,982700
4407,194,208,91975,3715,2154310,964100
4408,208,177,91787,3726,2154487,1094100
4409,167,200,91618,3695,2154687,1016900
4410,215,189,91400,3724,2154876,1024000
4411,207,175,91184,3765,2155051,1014900
4412,208,185,90981,3783,2155236,969300
4413,185,221,90792,3751,2155457,951500
4414,160,204,90638,3701,2155661,944200
4415,165,199,90472,3668,2155860,945200
4416,200,202,90271,3667,2156062,934300
4417,179,183,90090,3665,2156245,950600
4418,163,189,89925,3641,2156434,1185400
4419,165,193,89758,3615,2156627,961900
4420,140,204,89615,3554,2156831,955000
4421,161,188,89465,3516,2157019,960300
4422,172,181,89284,3516,2157200,962000
4423,178,203,89119,3478,2157403,991600
4424,196,178,88919,3500,2157581,982000
4425,170,179,88741,3499,2157760,987600
4426,169,173,88575,3492,2157933,958000
4427,168,195,88404,3468,2158128,964200
4428,156,175,88253,3444,2158303,964900
4429,160,157,88097,3443,2158460,948900
4430,169,161,87920,3459,2158621,1002600
4431,154,172,87765,3442,2158793,987200
4432,167,202,87603,3402,2158995,1035200
4433,172,189,87428,3388,2159184,992100
4434,163,165,87270,3381,2159349,942400
4435,164,189,87099,3363,2159538,969400
4436,154,184,86939,3339,2159722,991500
4437,153,162,86788,3328,2159884,956500
4438,170,180,86620,3316,2160064,966100
4439,182,166,86446,3324,2160230,965900
4440,158,157,86286,3327,2160387,988600
4441,168,163,86127,3323,2160550,1025000
4442,183,169,85939,3342,2160719,983300
4443,182,180,85759,3342,2160899,943500
4444,180,159,85579,3363,2161058,972600
4445,187,183,85384,3375,2161241,937400
4446,188,180,85209,3370,2161421,951000
4447,192,170,85011,3398,2161591,945000
4448,183,167,84826,3416,2161758,976800
4449,194,194,84645,3403,2161952,975700
4450,166,189,84461,3398,2162141,954400
4451,175,169,84286,3404,2162310,988200
4452,157,170,84130,3390,2162480,1020100
4453,173,160,83956,3404,2162640,1013400
4454,148,168,83808,3384,2162808,950900
4455,176,172,83645,3375,2162980,1025000
4456,201,172,83443,3405,2163152,1051900
4457,179,188,83254,3406,2163340,986100
4458,176,170,83071,3419,2163510,986500
4459,173,163,82913,3414,2163673,990900
4460,165,175,82744,3408,2163848,959900
4461,202,181,82540,3431,2164029,947600
4462,173,171,82364,3436,2164200,1004700
4463,166,171,82194,3435,2164371,984500
4464,171,166,82026,3437,2164537,976900
4465,170,149,81862,3452,2164686,1121900
4466,170,177,81691,3446,2164863,1008500
4467,165,196,81525,3416,2165059,977100
4468,185,162,81338,3441,2165221,1010800
4469,186,177,81167,3435,2165398,1077400
4470,191,176,80958,3468,2165574,1057300
4471,193,184,80766,3476,2165758,1118900
4472,187,177,80577,3488,2165935,1069000
4473,185,179,80396,3490,2166114,1003100
4474,175,172,80229,3485,2166286,1010400
4475,196,190,80019,3505,2166476,978500
4476,164,172,79854,3498,2166648,1002000
4477,190,191,79666,3495,2166839,1012800
4478,195,189,79475,3497,2167028,982800
4479,202,174,79278,3520,2167202,966400
4480,179,203,79100,3495,2167405,988600
4481,157,194,78930,3471,2167599,1037500
4482,171,172,78764,3465,2167771,1009100
4483,181,178,78589,3462,2167949,936800
4484,200,182,78378,3491,2168131,958600
4485,178,195,78202,3472,2168326,977700
4486,206,199,78016,3459,2168525,1103800
4487,160,180,77838,3457,2168705,1024900
4488,187,204,77657,3434,2168909,1030100
4489,166,173,77499,3419,2169082,1001000
4490,178,185,77313,3420,2169267,1000700
4491,168,182,77144,3407,2169449,978800
4492,154,192,76986,3373,2169641,978000
4493,152,176,76832,3351,2169817,986600
4494,164,170,76673,3340,2169987,959500
4495,171,195,76513,3305,2170182,938300
4496,188,180,76330,3308,2170362,958400
4497,151,184,76148,3306,2170546,1032500
4498,165,188,76003,3263,2170734,963400
4499,154,154,75841,3271,2170888,968100
4500,154,179,75692,3241,2171067,936700
4501,161,172,75528,3233,2171239,1180900
4502,171,177,75352,3232,2171416,1112800
4503,189,182,75174,3228,2171598,1046300
4504,185,172,74990,3240,2171770,1088600
4505,171,149,74811,3270,2171919,1032700
4506,167,179,74652,3250,2172098,1056200
4507,168,167,74481,3254,2172265,1053800
4508,177,176,74301,3258,2172441,1089700
4509,170,196,74129,3234,2172637,1019400
4510,162,179,73970,3214,2172816,979100
4511,186,169,73793,3222,2172985,1020100
4512,164,155,73613,3247,2173140,1068200
4513,163,187,73454,3219,2173327,1069300
4514,157,174,73300,3199,2173501,1072900
4515,167,167,73127,3205,2173668,1098500
4516,159,183,72965,3184,2173851,1105200
4517,170,172,72798,3179,2174023,1091400
4518,160,174,72645,3158,2174197,1123000
4519,149,160,72495,3148,2174357,1143200
4520,166,168,72321,3154,2174525,1093900
4521,161,161,72169,3145,2174686,1090200
4522,176,150,71994,3170,2174836,1061500
4523,147,194,71835,3135,2175030,1074200
4524,165,152,71688,3130,2175182,1101700
4525,149,153,71535,3130,2175335,1132000
4526,150,149,71379,3137,2175484,1050200
4527,159,165,71222,3129,2175649,1076500
4528,147,160,71071,3120,2175809,1152300
4529,150,161,70918,3112,2175970,1270300
4530,158,156,70762,3112,2176126,1130400
4531,165,143,70611,3120,2176269,1163900
4532,165,158,70438,3135,2176427,1125400
4533,166,173,70269,3131,2176600,1262800
4534,166,161,70105,3134,2176761,1174100
4535,148,159,69953,3127,2176920,1144100
4536,161,174,69795,3111,2177094,1105800
4537,160,158,69633,3115,2177252,1090400
4538,137,146,69500,3102,2177398,1181000
4539,164,176,69331,3095,2177574,1103900
4540,138,161,69184,3081,2177735,1055200
4541,131,159,69058,3048,2177894,1080900
4542,153,162,68909,3035,2178056,1033900
4543,164,160,68743,3041,2178216,1099700
4544,142,176,68598,3010,2178392,1112900
4545,131,147,68465,2996,2178539,1086400
4546,159,145,68319,2997,2178684,1165600
4547,153,151,68161,3004,2178835,1061400
4548,128,176,68032,2957,2179011,1102900
4549,136,164,67893,2932,2179175,1132100
4550,152,133,67743,2949,2179308,1074100
4551,145,171,67593,2928,2179479,1006600
4552,137,146,67456,2919,2179625,1053900
4553,166,161,67302,2912,2179786,1026900
4554,171,164,67125,2925,2179950,1176200
4555,125,164,66997,2889,2180114,1140400
4556,157,149,66832,2905,2180263,1063100
4557,141,172,66698,2867,2180435,1069900
4558,164,173,66537,2855,2180608,1156100
4559,130,164,66400,2828,2180772,1157800
4560,147,161,66257,2810,2180933,1147800
4561,145,140,66110,2817,2181073,1112000
4562,155,127,65962,2838,2181200,1092800
4563,166,150,65795,2855,2181350,1088400
4564,135,150,65647,2853,2181500,1024200
4565,133,146,65523,2831,2181646,1052900
4566,130,155,65384,2815,2181801,1150400
4567,143,142,65254,2803,2181943,1078800
4568,131,137,65121,2799,2182080,1071100
4569,130,130,64989,2801,2182210,1072500
4570,145,141,64844,2805,2182351,1067500
4571,136,153,64709,2787,2182504,1073900
4572,148,143,64561,2792,2182647,1169600
4573,122,127,64442,2784,2182774,1106000
4574,127,149,64304,2773,2182923,1119400
4575,149,159,64162,2756,2183082,1084400
4576,115,148,64042,2728,2183230,1094200
4577,155,145,63898,2727,2183375,1073100
4578,132,135,63767,2723,2183510,1088500
4579,108,124,63643,2723,2183634,1097900
4580,119,133,63527,2706,2183767,1102900
4581,137,134,63390,2709,2183901,1127200
4582,130,140,63266,2693,2184041,1060900
4583,166,126,63104,2729,2184167,1110000
4584,133,143,62960,2730,2184310,1082700
4585,129,128,62829,2733,2184438,1054600
4586,139,128,62704,2730,2184566,1095000
4587,142,152,62553,2729,2184718,1099100
4588,158,146,62401,2735,2184864,1053800
4589,128,135,62271,2730,2184999,1079600
4590,137,146,62133,2722,2185145,1145400
4591,117,147,62011,2697,2185292,1164900
4592,120,172,61885,2651,2185464,1137100
4593,125,137,61769,2630,2185601,1018800
4594,128,143,61642,2614,2185744,1132300
4595,134,122,61510,2624,2185866,1170500
4596,112,156,61394,2584,2186022,1129900
4597,110,129,61274,2575,2186151,1129200
4598,126,130,61160,2559,2186281,1136400
4599,88,132,61068,2519,2186413,1230600
4600,126,135,60945,2507,2186548,1218500
4601,127,140,60828,2484,2186688,1249500
4602,126,123,60693,2496,2186811,1127500
4603,106,115,60589,2485,2186926,1088900
4604,102,119,60478,2477,2187045,1101800
4605,106,130,60374,2451,2187175,1071700
4606,114,124,60269,2432,2187299,1334200
4607,113,114,60147,2440,2187413,1129600
4608,112,110,60039,2438,2187523,1123800
4609,114,119,59926,2432,2187642,1152100
4610,115,126,59813,2419,2187768,1067100
4611,126,118,59686,2428,2187886,1074300
4612,118,121,59572,2421,2188007,1069700
4613,118,127,59448,2418,2188134,1085200
4614,126,105,59324,2437,2188239,1130600
4615,100,149,59211,2401,2188388,1135900
4616,117,129,59111,2372,2188517,1084100
4617,124,117,58975,2391,2188634,1115300
4618,104,90,58872,2404,2188724,1135400
4619,112,120,58760,2396,2188844,1058300
4620,111,134,58650,2372,2188978,1070500
4621,108,129,58544,2349,2189107,1043400
4622,103,115,58434,2344,2189222,1049700
4623,97,129,58341,2308,2189351,1091100
4624,98,117,58250,2282,2189468,1084700
4625,103,108,58141,2283,2189576,1086700
4626,123,136,58023,2265,2189712,1089300
4627,103,125,57913,2250,2189837,1133000
4628,126,120,57792,2251,2189957,1085600
4629,118,113,57679,2251,2190070,1116800
4630,99,114,57570,2246,2190184,1064000
4631,113,109,57462,2245,2190293,1108300
4632,102,115,57357,2235,2190408,1187700
4633,88,125,57262,2205,2190533,1114100
4634,91,87,57177,2203,2190620,1162400
4635,112,111,57061,2208,2190731,1071000
4636,120,107,56956,2206,2190838,1188500
4637,118,108,56833,2221,2190946,1101300
4638,119,108,56706,2240,2191054,1089700
4639,107,93,56595,2258,2191147,1073300
4640,109,134,56489,2230,2191281,1047100
4641,111,103,56388,2228,2191384,1050500
4642,117,112,56266,2238,2191496,1107600
4643,122,145,56137,2222,2191641,1103700
4644,111,123,56030,2206,2191764,1069700
4645,102,124,55924,2188,2191888,1102700
4646,121,125,55807,2180,2192013,1142500
4647,103,100,55707,2180,2192113,1062400
4648,93,109,55608,2170,2192222,1149900
4649,121,111,55494,2173,2192333,1199600
4650,103,119,55388,2160,2192452,1152600
4651,98,122,55291,2135,2192574,1196100
4652,107,113,55188,2125,2192687,1251800
4653,94,114,55091,2108,2192801,1260100
4654,87,93,54996,2110,2192894,1167300
4655,97,84,54908,2114,2192978,1107000
4656,106,120,54794,2108,2193098,1255400
4657,105,98,54691,2113,2193196,1153600
4658,86,94,54603,2107,2193290,1100200
4659,100,112,54515,2083,2193402,1113100
4660,84,102,54421,2075,2193504,1073800
4661,83,110,54335,2051,2193614,1091400
4662,96,106,54244,2036,2193720,1120900
4663,98,107,54148,2025,2193827,1089000
4664,86,108,54055,2010,2193935,1074200
4665,85,95,53975,1995,2194030,1275700
4666,99,91,53879,2000,2194121,1090300
4667,99,89,53779,2011,2194210,1067400
4668,95,92,53684,2014,2194302,1082900
4669,119,111,53559,2028,2194413,1025700
4670,102,79,53462,2046,2194492,1100000
4671,95,105,53365,2038,2194597,1075200
4672,79,96,53281,2026,2194693,1107200
4673,97,109,53182,2016,2194802,1103000
4674,62,102,53118,1978,2194904,1057500
4675,97,94,53032,1970,2194998,1074000
4676,104,112,52927,1963,2195110,1083900
4677,91,88,52832,1970,2195198,1054200
4678,87,89,52750,1963,2195287,1079100
4679,87,102,52651,1960,2195389,1073400
4680,81,97,52576,1938,2195486,1036400
4681,84,106,52495,1913,2195592,1078800
4682,84,87,52409,1912,2195679,1117600
4683,101,111,52308,1902,2195790,1068000
4684,86,99,52214,1897,2195889,1104400
4685,80,99,52142,1870,2195988,1121200
4686,83,108,52051,1853,2196096,1175200
4687,85,98,51971,1835,2196194,1186000
4688,84,91,51890,1825,2196285,1296900
4689,75,84,51811,1820,2196369,1187700
4690,106,107,51714,1810,2196476,1287600
4691,67,88,51639,1797,2196564,1122300
4692,94,110,51547,1779,2196674,1114500
4693,85,84,51462,1780,2196758,1100600
4694,68,73,51397,1772,2196831,1073700
4695,62,101,51330,1738,2196932,1111900
4696,76,86,51259,1723,2197018,1071600
4697,82,92,51174,1716,2197110,1009600
4698,76,85,51098,1707,2197195,1053000
4699,65,102,51026,1677,2197297,1078800
4700,76,82,50952,1669,2197379,988000
4701,80,78,50879,1664,2197457,1077200
4702,68,90,50804,1649,2197547,1094900
4703,71,105,50741,1607,2197652,1010900
4704,84,79,50658,1611,2197731,966700
4705,86,82,50568,1619,2197813,961200
4706,72,86,50496,1605,2197899,1014000
4707,84,76,50411,1614,2197975,1059000
4708,74,85,50340,1600,2198060,1146700
4709,76,92,50262,1586,2198152,1032000
4710,75,98,50187,1563,2198250,982100
4711,100,66,50088,1596,2198316,1030000
4712,83,80,50000,1604,2198396,1128200
4713,84,66,49920,1618,2198462,1123600
4714,80,94,49843,1601,2198556,1178900
4715,89,86,49761,1597,2198642,1068700
4716,92,79,49665,1614,2198721,1026600
4717,73,81,49583,1615,2198802,995500
4718,79,89,49509,1600,2198891,1015600
4719,84,64,49416,1629,2198955,975400
4720,80,89,49344,1612,2199044,1029800
4721,96,88,49249,1619,2199132,967800
4722,85,90,49167,1611,2199222,947200
4723,74,89,49085,1604,2199311,950200
4724,88,81,49000,1608,2199392,934600
4725,86,84,48919,1605,2199476,1024000
4726,97,80,48818,1626,2199556,954100
4727,82,68,48730,1646,2199624,1074900
4728,71,77,48661,1638,2199701,1047000
4729,69,81,48589,1629,2199782,1185700
4730,72,90,48520,1608,2199872,1046900
4731,94,83,48426,1619,2199955,980000
4732,70,65,48356,1624,2200020,976400
4733,86,96,48271,1613,2200116,1012700
4734,68,81,48199,1604,2200197,955500
4735,82,79,48131,1593,2200276,1015500
4736,69,89,48051,1584,2200365,994800
4737,78,70,47975,1590,2200435,978600
4738,62,81,47915,1569,2200516,1001300
4739,86,84,47825,1575,2200600,1063300
4740,70,81,47748,1571,2200681,1045000
4741,80,101,47677,1541,2200782,1014500
4742,85,77,47592,1549,2200859,1003700
4743,77,84,47514,1543,2200943,1012300
4744,67,104,47448,1505,2201047,1023100
4745,74,69,47371,1513,2201116,1172900
4746,60,59,47310,1515,2201175,993400
4747,66,97,47247,1481,2201272,1046200
4748,64,86,47182,1460,2201358,998400
4749,76,76,47105,1461,2201434,1007700
4750,76,81,47032,1453,2201515,1016100
4751,77,65,46959,1461,2201580,985800
4752,82,69,46871,1480,2201649,958000
4753,60,85,46806,1460,2201734,961000
4754,75,82,46741,1443,2201816,1012400
4755,80,82,46653,1449,2201898,975000
4756,64,66,46591,1445,2201964,1056800
4757,68,71,46527,1438,2202035,1006400
4758,77,77,46450,1438,2202112,1037900
4759,64,80,46380,1428,2202192,1055200
4760,66,78,46317,1413,2202270,1014800
4761,57,64,46256,1410,2202334,1003200
4762,63,73,46194,1399,2202407,1028500
4763,71,71,46125,1397,2202478,946800
4764,61,84,46067,1371,2202562,995700
4765,77,54,45991,1393,2202616,991700
4766,58,70,45932,1382,2202686,1086600
4767,70,75,45861,1378,2202761,991000
4768,91,74,45777,1388,2202835,945100
4769,85,69,45686,1410,2202904,964000
4770,78,71,45606,1419,2202975,956500
4771,81,80,45529,1416,2203055,972100
4772,70,64,45453,1428,2203119,1002900
4773,68,77,45386,1418,2203196,1014600
4774,81,58,45307,1439,2203254,1027300
4775,59,77,45244,1425,2203331,1181900
4776,64,76,45181,1412,2203407,1093800
4777,67,74,45117,1402,2203481,1051600
4778,60,64,45053,1402,2203545,1007400
4779,57,62,45000,1393,2203607,1041400
4780,57,78,44941,1374,2203685,1033100
4781,65,65,44880,1370,2203750,984900
4782,43,66,44829,1355,2203816,1111500
4783,64,65,44772,1347,2203881,1117400
4784,71,61,44699,1359,2203942,1070700
4785,68,76,44632,1350,2204018,1068500
4786,57,72,44579,1331,2204090,1219200
4787,49,72,44525,1313,2204162,988800
4788,65,60,44457,1321,2204222,973800
4789,55,59,44405,1314,2204281,1091000
4790,53,64,44350,1305,2204345,1044900
4791,62,61,44291,1303,2204406,982200
4792,65,64,44222,1308,2204470,989700
4793,56,77,44173,1280,2204547,964000
4794,57,63,44119,1271,2204610,1000900
4795,50,63,44062,1265,2204673,994300
4796,57,58,44006,1263,2204731,965600
4797,62,63,43946,1260,2204794,986200
4798,81,78,43863,1265,2204872,1029100
4799,63,69,43793,1266,2204941,947800
4800,59,55,43738,1266,2204996,978000
4801,40,62,43697,1245,2205058,982900
4802,52,82,43643,1217,2205140,1002000
4803,52,62,43591,1207,2205202,1008400
4804,58,55,43536,1207,2205257,1014400
4805,61,76,43475,1192,2205333,1102100
4806,52,58,43421,1188,2205391,1088800
4807,57,55,43367,1187,2205446,977200
4808,67,65,43302,1187,2205511,1016800
4809,70,54,43235,1200,2205565,948100
4810,63,79,43174,1182,2205644,959400
4811,37,59,43127,1170,2205703,969500
4812,56,66,43072,1159,2205769,952500
4813,50,43,43029,1159,2205812,994100
4814,54,60,42970,1158,2205872,975100
4815,56,48,42912,1168,2205920,1051400
4816,57,54,42853,1173,2205974,964100
4817,59,60,42804,1162,2206034,975300
4818,60,49,42735,1182,2206083,966300
4819,64,73,42670,1174,2206156,1007000
4820,54,68,42615,1161,2206224,988000
4821,59,50,42561,1165,2206274,1016500
4822,51,60,42508,1158,2206334,971000
4823,38,66,42470,1130,2206400,973100
4824,51,61,42415,1124,2206461,1062900
4825,42,69,42372,1098,2206530,1040300
4826,49,53,42329,1088,2206583,1011800
4827,44,65,42283,1069,2206648,986600
4828,43,49,42236,1067,2206697,959100
4829,48,52,42189,1062,2206749,972100
4830,58,59,42137,1055,2206808,991500
4831,36,53,42096,1043,2206861,996600
4832,29,49,42067,1023,2206910,931200
4833,47,50,42020,1020,2206960,918600
4834,48,49,41973,1018,2207009,1015000
4835,46,56,41929,1006,2207065,991700
4836,39,51,41884,1000,2207116,952000
4837,58,51,41833,1000,2207167,1005900
4838,29,62,41799,972,2207229,977000
4839,27,53,41773,945,2207282,989400
4840,60,38,41717,963,2207320,979300
4841,48,59,41666,955,2207379,958500
4842,40,33,41625,963,2207412,970000
4843,50,39,41574,975,2207451,1006800
4844,44,51,41530,968,2207502,944800
4845,36,51,41489,958,2207553,985700
4846,40,36,41455,956,2207589,929600
4847,47,47,41410,954,2207636,932100
4848,52,53,41358,953,2207689,1046500
4849,35,54,41317,940,2207743,1082300
4850,42,44,41283,930,2207787,1040100
4851,37,68,41238,907,2207855,1007900
4852,38,56,41206,883,2207911,990100
4853,49,46,41161,882,2207957,1002700
4854,43,62,41109,872,2208019,955900
4855,41,46,41071,864,2208065,977800
4856,42,42,41028,865,2208107,954600
4857,27,42,41002,849,2208149,946800
4858,38,41,40966,844,2208190,923900
4859,31,32,40937,841,2208222,948500
4860,40,54,40894,830,2208276,939700
4861,47,50,40850,824,2208326,974900
4862,35,48,40808,818,2208374,967700
4863,35,35,40781,810,2208409,941200
4864,45,41,40734,816,2208450,937500
4865,37,35,40693,822,2208485,944700
4866,36,45,40657,813,2208530,929600
4867,30,43,40627,800,2208573,913800
4868,42,49,40587,791,2208622,906800
4869,45,33,40539,806,2208655,1000900
4870,41,46,40499,800,2208701,1067700
4871,34,54,40468,777,2208755,1049900
4872,37,44,40429,772,2208799,1041400
4873,38,51,40390,760,2208850,1020200
4874,37,45,40353,752,2208895,1044900
4875,33,38,40321,746,2208933,1027400
4876,39,42,40281,744,2208975,1032700
4877,39,39,40246,740,2209014,969600
4878,35,38,40209,739,2209052,973300
4879,45,30,40160,758,2209082,972400
4880,37,36,40126,756,2209118,1044200
4881,36,42,40094,746,2209160,1039000
4882,45,29,40049,762,2209189,1076700
4883,42,32,40004,775,2209221,1022600
4884,28,42,39971,766,2209263,1119600
4885,34,43,39941,753,2209306,1162200
4886,29,35,39910,749,2209341,1057700
4887,35,31,39874,754,2209372,1061500
4888,51,38,39831,759,2209410,1027300
4889,33,31,39793,766,2209441,1041500
4890,42,43,39750,766,2209484,991400
4891,43,58,39710,748,2209542,986900
4892,31,46,39676,736,2209588,992400
4893,42,40,39632,740,2209628,1028500
4894,43,43,39597,732,2209671,1018500
4895,45,45,39550,734,2209716,1007300
4896,44,40,39505,739,2209756,996000
4897,32,39,39472,733,2209795,1012600
4898,44,37,39425,743,2209832,1047700
4899,38,43,39388,737,2209875,1061200
4900,40,49,39354,722,2209924,1050000
4901,23,45,39326,705,2209969,1071800
4902,30,29,39293,709,2209998,1059700
4903,38,45,39262,695,2210043,1105700
4904,36,39,39222,696,2210082,1258100
4905,39,30,39183,705,2210112,1132500
4906,26,39,39155,694,2210151,1181100
4907,33,31,39120,698,2210182,1123700
4908,26,32,39098,688,2210214,1307500
4909,27,37,39067,682,2210251,1215000
4910,28,31,39043,675,2210282,1182000
4911,31,32,39016,670,2210314,1193600
4912,27,35,38982,669,2210349,1334600
4913,28,40,38959,652,2210389,1191900
4914,41,33,38918,660,2210422,1236600
4915,36,32,38879,667,2210454,1133000
4916,23,29,38856,661,2210483,1118800
4917,32,18,38822,677,2210501,1094900
4918,36,44,38786,669,2210545,1051500
4919,33,38,38758,659,2210583,1068600
4920,29,43,38728,646,2210626,988700
4921,49,46,38677,651,2210672,1171700
4922,33,38,38647,643,2210710,1066500
4923,37,27,38610,653,2210737,1011500
4924,35,37,38572,654,2210774,968300
4925,28,40,38542,644,2210814,944200
4926,34,41,38512,633,2210855,972900
4927,29,35,38483,627,2210890,1032000
4928,28,32,38453,625,2210922,994000
4929,32,36,38421,621,2210958,945300
4930,37,31,38383,628,2210989,917900
4931,31,28,38350,633,2211017,937400
4932,33,35,38317,631,2211052,1053600
4933,36,34,38284,630,2211086,930900
4934,30,29,38256,629,2211115,932400
4935,28,36,38225,624,2211151,940400
4936,43,40,38184,625,2211191,912300
4937,23,34,38159,616,2211225,923900
4938,34,26,38126,623,2211251,969300
4939,35,24,38096,629,2211275,961900
4940,36,29,38053,643,2211304,925400
4941,27,41,38024,631,2211345,936200
4942,34,39,37993,623,2211384,915700
4943,26,25,37966,625,2211409,1027500
4944,28,17,37938,636,2211426,1010500
4945,28,28,37910,636,2211454,1009700
4946,29,25,37880,641,2211479,990400
4947,25,44,37856,621,2211523,962400
4948,31,29,37827,621,2211552,935900
4949,29,25,37796,627,2211577,986800
4950,20,30,37773,620,2211607,967100
4951,25,26,37750,617,2211633,937700
4952,23,32,37726,609,2211665,944400
4953,29,30,37700,605,2211695,927000
4954,31,37,37672,596,2211732,896600
4955,31,42,37639,587,2211774,939400
4956,27,34,37609,583,2211808,1055200
4957,26,30,37587,575,2211838,919100
4958,18,25,37562,575,2211863,963000
4959,24,26,37540,571,2211889,960500
4960,22,28,37519,564,2211917,922400
4961,21,31,37496,556,2211948,918600
4962,18,30,37478,544,2211978,950200
4963,20,20,37459,543,2211998,909000
4964,24,26,37434,542,2212024,899000
4965,24,19,37412,545,2212043,934400
4966,27,23,37388,546,2212066,914400
4967,21,33,37361,540,2212099,907800
4968,24,23,37339,539,2212122,914000
4969,25,26,37318,534,2212148,967300
4970,26,25,37290,537,2212173,1007800
4971,31,28,37263,536,2212201,920800
4972,18,22,37241,536,2212223,954300
4973,20,25,37224,528,2212248,1017500
4974,25,31,37196,525,2212279,1041600
4975,21,21,37178,522,2212300,1018200
4976,26,23,37147,530,2212323,1031700
4977,21,29,37129,519,2212352,976700
4978,24,21,37104,523,2212373,939400
4979,20,24,37086,517,2212397,958200
4980,22,21,37062,520,2212418,938800
4981,18,19,37043,520,2212437,918600
4982,18,31,37026,506,2212468,947000
4983,21,23,37006,503,2212491,970200
4984,24,20,36979,510,2212511,942700
4985,20,24,36961,504,2212535,931600
4986,17,27,36940,498,2212562,914700
4987,23,21,36921,496,2212583,917900
4988,12,18,36908,491,2212601,900100
4989,22,24,36885,490,2212625,928400
4990,12,25,36871,479,2212650,1026000
4991,18,28,36857,465,2212678,1002400
4992,13,26,36844,452,2212704,996200
4993,16,24,36826,446,2212728,999800
4994,15,22,36809,441,2212750,972500
4995,15,12,36797,441,2212762,940900
4996,16,28,36780,430,2212790,931400
4997,9,21,36771,418,2212811,933600
4998,19,22,36754,413,2212833,984200
4999,9,20,36741,406,2212853,948000
5000,17,21,36728,398,2212874,957600
5001,17,22,36709,395,2212896,937100
5002,21,17,36688,399,2212913,927500
5003,13,19,36675,393,2212932,1150800
5004,8,21,36667,380,2212953,974400
5005,14,8,36653,386,2212961,929100
5006,19,18,36636,385,2212979,957500
5007,14,25,36621,375,2213004,968600
5008,21,22,36603,371,2213026,967700
5009,18,17,36581,376,2213043,923700
5010,23,19,36557,381,2213062,889900
5011,20,21,36538,379,2213083,928700
5012,18,18,36522,377,2213101,933700
5013,15,18,36507,374,2213119,970500
5014,16,22,36489,370,2213141,956400
5015,18,8,36471,380,2213149,926500
5016,17,15,36455,381,2213164,914600
5017,15,15,36441,380,2213179,919100
5018,21,17,36419,385,2213196,908000
5019,18,30,36402,372,2213226,891600
5020,22,21,36379,374,2213247,956800
5021,16,17,36362,374,2213264,907800
5022,18,24,36344,368,2213288,889500
5023,23,18,36322,372,2213306,1015000
5024,23,20,36296,378,2213326,994000
5025,30,18,36270,386,2213344,978500
5026,29,25,36242,389,2213369,950600
5027,24,25,36218,388,2213394,956300
5028,24,21,36192,393,2213415,914600
5029,31,23,36163,399,2213438,937200
5030,18,20,36145,397,2213458,958600
5031,24,20,36118,404,2213478,958600
5032,25,21,36096,405,2213499,933500
5033,25,15,36070,416,2213514,924600
5034,22,19,36047,420,2213533,962500
5035,17,21,36030,416,2213554,976500
5036,25,21,36005,420,2213575,969500
5037,18,15,35986,424,2213590,940400
5038,16,31,35970,409,2213621,976300
5039,18,31,35956,392,2213652,1025900
5040,17,21,35935,392,2213673,1067100
5041,12,22,35923,382,2213695,1015100
5042,15,18,35909,378,2213713,997700
5043,13,23,35897,367,2213736,974600
5044,14,28,35881,355,2213764,989800
5045,19,25,35860,351,2213789,1089500
5046,17,24,35846,341,2213813,974900
5047,12,15,35834,338,2213828,918000
5048,18,17,35815,340,2213845,987600
5049,15,20,35800,335,2213865,987700
5050,16,13,35783,339,2213878,1029200
5051,17,12,35767,343,2213890,1010700
5052,11,14,35756,340,2213904,949200
5053,9,13,35746,337,2213917,937000
5054,16,18,35732,333,2213935,1014200
5055,15,24,35719,322,2213959,999900
5056,16,20,35702,319,2213979,938000
5057,20,16,35680,325,2213995,925000
5058,12,16,35669,320,2214011,893000
5059,19,18,35651,320,2214029,964100
5060,12,23,35636,312,2214052,925900
5061,17,23,35620,305,2214075,931400
5062,15,16,35604,305,2214091,907600
5063,12,19,35595,295,2214110,875400
5064,14,17,35579,294,2214127,886900
5065,10,12,35568,293,2214139,974700
5066,8,19,35562,280,2214158,954300
5067,9,18,35552,272,2214176,918300
5068,11,14,35540,270,2214190,953200
5069,12,17,35530,263,2214207,906000
5070,9,11,35520,262,2214218,966900
5071,8,18,35511,253,2214236,921400
5072,11,7,35501,256,2214243,921200
5073,9,6,35494,257,2214249,924300
5074,12,18,35480,253,2214267,912300
5075,9,8,35469,256,2214275,957500
5076,13,14,35457,254,2214289,952400
5077,11,14,35447,250,2214303,941000
5078,13,14,35435,248,2214317,900100
5079,24,14,35410,259,2214331,936200
5080,9,10,35402,257,2214341,931400
5081,14,13,35386,260,2214354,922900
5082,14,13,35373,260,2214367,898900
5083,5,12,35367,254,2214379,923400
5084,20,10,35349,262,2214389,904100
5085,9,10,35337,264,2214399,889300
5086,15,17,35324,260,2214416,898600
5087,14,11,35308,265,2214427,1045900
5088,11,17,35299,257,2214444,980700
5089,18,5,35279,272,2214449,926300
5090,10,14,35271,266,2214463,912400
5091,13,13,35258,266,2214476,929900
5092,11,7,35246,271,2214483,932700
5093,9,12,35236,269,2214495,891400
5094,15,16,35224,265,2214511,924800
5095,10,17,35212,260,2214528,920800
5096,19,13,35193,266,2214541,939700
5097,19,13,35176,270,2214554,941900
5098,6,18,35168,260,2214572,985500
5099,12,16,35157,255,2214588,953500
5100,14,7,35144,261,2214595,1000900
5101,6,23,35137,245,2214618,939600
5102,6,15,35129,238,2214633,940300
5103,14,16,35117,234,2214649,981500
5104,8,13,35110,228,2214662,955600
5105,10,17,35098,223,2214679,941900
5106,9,12,35088,221,2214691,934700
5107,8,8,35081,220,2214699,976100
5108,8,8,35075,218,2214707,975700
5109,11,12,35063,218,2214719,1065000
5110,11,11,35052,218,2214730,982500
5111,14,12,35037,221,2214742,935600
5112,13,11,35024,223,2214753,998500
5113,9,10,35016,221,2214763,971200
5114,9,10,35007,220,2214773,960100
5115,14,6,34994,227,2214779,934600
5116,6,10,34987,224,2214789,924700
5117,8,15,34979,217,2214804,1092600
5118,12,13,34967,216,2214817,1030500
5119,9,9,34960,214,2214826,1086900
5120,7,13,34950,211,2214839,1088900
5121,9,10,34942,209,2214849,1001200
5122,6,11,34935,205,2214860,1007400
5123,13,13,34922,205,2214873,1005600
5124,14,10,34910,207,2214883,966500
5125,12,13,34895,209,2214896,944000
5126,8,10,34888,206,2214906,937300
5127,2,11,34885,198,2214917,983900
5128,7,9,34879,195,2214926,1107100
5129,6,11,34872,191,2214937,934100
5130,7,9,34867,187,2214946,910500
5131,8,9,34857,188,2214955,926700
5132,5,12,34852,181,2214967,926300
5133,5,14,34849,170,2214981,896500
5134,7,4,34841,174,2214985,917400
5135,0,8,34840,167,2214993,981300
5136,4,7,34838,162,2215000,997700
5137,3,10,34834,156,2215010,1013300
5138,8,8,34825,157,2215018,977800
5139,6,9,34820,153,2215027,984900
5140,3,11,34816,146,2215038,924000
5141,10,8,34807,147,2215046,929900
5142,4,9,34802,143,2215055,1007400
5143,2,11,34800,134,2215066,959100
5144,5,7,34795,132,2215073,979200
5145,5,0,34790,137,2215073,965500
5146,3,6,34787,134,2215079,968400
5147,6,7,34781,133,2215086,929200
5148,3,6,34779,129,2215092,968200
5149,5,10,34774,124,2215102,941700
5150,6,6,34769,123,2215108,950800
5151,1,7,34766,119,2215115,996700
5152,5,7,34762,116,2215122,1056100
5153,9,4,34752,122,2215126,1014200
5154,5,6,34748,120,2215132,1000700
5155,5,6,34744,118,2215138,1013900
5156,6,6,34738,118,2215144,967200
5157,6,6,34730,120,2215150,955800
5158,5,5,34726,119,2215155,961500
5159,4,3,34721,121,2215158,1040100
5160,3,10,34718,114,2215168,976900
5161,6,8,34715,109,2215176,957300
5162,4,7,34709,108,2215183,1002100
5163,8,4,34700,113,2215187,1011700
5164,5,5,34696,112,2215192,982700
5165,5,4,34693,111,2215196,992300
5166,4,7,34687,110,2215203,1007600
5167,6,4,34683,110,2215207,946800
5168,2,5,34678,110,2215212,1079000
5169,5,5,34675,108,2215217,1078000
5170,6,5,34667,111,2215222,1006100
5171,3,8,34665,105,2215230,988900
5172,2,5,34663,102,2215235,1026100
5173,9,5,34654,106,2215240,983500
5174,4,6,34649,105,2215246,955500
5175,5,5,34645,104,2215251,1004000
5176,6,6,34638,105,2215257,1020300
5177,7,2,34631,110,2215259,1104600
5178,8,10,34624,107,2215269,1077400
5179,5,11,34618,102,2215280,1013700
5180,9,5,34612,103,2215285,1024200
5181,4,6,34605,104,2215291,1100600
5182,4,10,34601,98,2215301,1007600
5183,6,6,34595,98,2215307,1050100
5184,5,2,34591,100,2215309,1028400
5185,5,5,34585,101,2215314,1053700
5186,8,5,34578,103,2215319,1157700
5187,2,6,34576,99,2215325,1109200
5188,3,5,34572,98,2215330,1051300
5189,6,7,34566,97,2215337,1051500
5190,1,7,34565,91,2215344,1001100
5191,3,3,34562,91,2215347,978700
5192,4,2,34560,91,2215349,982900
5193,2,5,34556,90,2215354,946700
5194,2,6,34555,85,2215360,994700
5195,3,5,34551,84,2215365,978700
5196,5,4,34547,84,2215369,1015100
5197,3,1,34544,86,2215370,1052400
5198,4,4,34539,87,2215374,1083200
5199,2,2,34538,86,2215376,1057400
5200,7,6,34530,88,2215382,1003700
5201,2,3,34528,87,2215385,959500
5202,3,4,34526,85,2215389,983100
5203,0,5,34525,81,2215394,975300
5204,2,3,34524,79,2215397,983800
5205,1,5,34522,76,2215402,970200
5206,3,2,34519,77,2215404,968700
5207,5,6,34514,76,2215410,1004400
5208,1,3,34513,74,2215413,1000700
5209,1,5,34512,70,2215418,987300
5210,1,1,34511,70,2215419,962800
5211,4,1,34507,73,2215420,943400
5212,4,6,34504,70,2215426,912000
5213,1,7,34502,65,2215433,933200
5214,2,1,34501,65,2215434,1001600
5215,1,3,34499,64,2215437,992700
5216,1,2,34498,63,2215439,978900
5217,3,5,34495,61,2215444,973900
5218,1,4,34494,58,2215448,1005000
5219,2,1,34492,59,2215449,967600
5220,5,3,34488,60,2215452,936700
5221,1,5,34487,56,2215457,933600
5222,3,2,34483,58,2215459,906800
5223,1,1,34483,57,2215460,988400
5224,2,2,34480,58,2215462,983000
5225,3,2,34477,59,2215464,956700
5226,4,0,34473,63,2215464,924200
5227,3,3,34470,63,2215467,953900
5228,1,2,34469,62,2215469,996300
5229,0,5,34469,57,2215474,1021900
5230,0,2,34469,55,2215476,978800
5231,0,4,34469,51,2215480,978500
5232,0,2,34469,49,2215482,1044400
5233,0,0,34469,49,2215482,974800
5234,0,4,34469,45,2215486,954500
5235,1,2,34468,44,2215488,993700
5236,2,2,34466,44,2215490,911300
5237,1,5,34465,40,2215495,920700
5238,0,0,34465,40,2215495,927000
5239,1,2,34465,38,2215497,954300
5240,0,1,34464,38,2215498,923500
5241,0,1,34464,37,2215499,937300
5242,0,4,34464,33,2215503,910500
5243,0,1,34464,32,2215504,932400
5244,0,1,34464,31,2215505,941000
5245,0,2,34464,29,2215507,1031700
5246,0,1,34464,28,2215508,984200
5247,0,0,34464,28,2215508,991400
5248,0,2,34464,26,2215510,950700
5249,0,1,34464,25,2215511,1004700
5250,0,0,34464,25,2215511,971700
5251,0,0,34464,25,2215511,982900
5252,0,0,34464,25,2215511,974800
5253,0,5,34464,20,2215516,1021600
5254,0,2,34464,18,2215518,1026400
5255,0,1,34464,17,2215519,960500
5256,0,2,34464,15,2215521,926100
5257,1,1,34464,14,2215522,933200
5258,0,0,34463,15,2215522,972200
5259,0,0,34463,15,2215522,963100
5260,0,1,34463,14,2215523,943900
5261,0,0,34463,14,2215523,939400
5262,0,3,34463,11,2215526,924700
5263,0,1,34463,10,2215527,960000
5264,0,2,34463,8,2215529,902300
5265,0,1,34463,7,2215530,899700
5266,0,1,34463,6,2215531,889200
5267,0,0,34463,6,2215531,898800
5268,0,0,34463,6,2215531,916100
5269,0,0,34463,6,2215531,941100
5270,2,0,34461,8,2215531,923000
5271,0,1,34461,7,2215532,984600
5272,0,0,34461,7,2215532,943700
5273,0,2,34461,5,2215534,920900
5274,0,1,34461,4,2215535,917300
5275,1,0,34461,4,2215535,920100
5276,1,0,34459,6,2215535,895900
5277,0,0,34459,6,2215535,941600
5278,0,0,34459,6,2215535,986700
5279,0,0,34459,6,2215535,937400
5280,0,0,34459,6,2215535,961800
5281,0,0,34459,6,2215535,969400
5282,0,0,34459,6,2215535,915000
5283,0,0,34459,6,2215535,924200
5284,2,1,34457,7,2215536,901600
5285,0,1,34457,6,2215537,898500
5286,0,0,34457,6,2215537,914600
5287,0,0,34457,6,2215537,909600
5288,0,0,34457,6,2215537,932700
5289,0,1,34457,5,2215538,902300
5290,0,0,34457,5,2215538,913200
5291,0,0,34457,5,2215538,994100
5292,0,0,34457,5,2215538,1040200
5293,0,0,34457,5,2215538,1009000
5294,0,0,34457,5,2215538,1040700
5295,0,0,34457,5,2215538,1026400
5296,0,0,34457,5,2215538,940200
5297,0,0,34457,5,2215538,961900
5298,0,0,34457,5,2215538,1049500
5299,0,1,34457,4,2215539,1002900
5300,0,0,34457,4,2215539,927100
5301,0,0,34457,4,2215539,990300
5302,0,0,34457,4,2215539,1019400
5303,0,1,34457,3,2215540,1047800
5304,0,0,34457,3,2215540,1008700
5305,0,0,34457,3,2215540,960400
5306,0,0,34457,3,2215540,933400
5307,0,0,34457,3,2215540,939400
5308,0,0,34457,3,2215540,1020300
5309,0,0,34457,3,2215540,988500
5310,0,0,34457,3,2215540,1026700
5311,0,0,34457,3,2215540,1008100
5312,0,1,34457,2,2215541,1091500
5313,0,0,34457,2,2215541,1062400
5314,0,2,34457,0,2215543,1034400
